,Player,Game,Games Started,Minutes Played,Field Goals,Field Goals Attempted,Three Point Field Goals,Three Pointers Attempted,Two Point Field Goals,Two Pointers Attempted,Free Throws Made,Free Throws Attempted,Offensive Rebounds,Defensive Rebounds,Total Rebounds,Assists,Steals,Blocks,Turnovers,Personal Fouls,Points
0,A.J. Green,35,1,345,53,125,44,105,9,20,4,4,6,39,45,22,6,0,9,31,154
1,A.J. Hammons,22,0,163,17,42,5,10,12,32,9,20,8,28,36,4,1,13,10,21,48
2,A.J. Lawson,30,0,216,44,88,20,50,24,38,4,16,12,30,42,4,4,0,6,22,112
3,A.J. Price,287,25,4253,600,1581,233,747,367,834,223,303,74,335,409,613,132,9,243,252,1656
4,AJ Griffin,72,12,1401,248,533,101,259,147,274,42,47,37,116,153,73,42,12,42,87,639
5,Aaron Brooks,698,192,14671,2448,5954,887,2418,1561,3536,973,1161,284,880,1164,2180,416,100,1114,1351,6756
6,Aaron Gordon,646,557,18716,3265,6923,706,2168,2559,4755,1378,2015,1082,2958,4040,1677,476,420,987,1271,8614
7,Aaron Gray,270,74,3189,325,636,0,2,325,634,127,221,364,655,1019,164,78,72,217,544,777
8,Aaron Harrison,35,3,343,24,92,12,55,12,37,19,31,8,34,42,16,15,2,7,39,79
9,Aaron Henry,6,0,17,1,5,0,1,1,4,0,0,0,1,1,0,0,2,2,2,2
10,Aaron Holiday,371,77,6326,902,2157,311,824,591,1333,328,388,115,515,630,830,243,72,364,548,2443
11,Aaron Jackson,1,0,35,3,9,1,4,2,5,1,2,2,1,3,1,0,0,1,4,8
12,Aaron Nesmith,171,64,3059,402,950,186,537,216,413,162,196,105,388,493,143,90,48,129,392,1152
13,Aaron Wiggins,120,49,2506,342,700,90,260,252,440,121,156,119,269,388,148,69,25,109,203,895
14,Abdel Nader,202,8,2583,333,778,125,350,208,428,135,188,52,324,376,110,76,55,133,245,926
15,Acie Law,154,2,1920,232,522,22,104,210,418,170,226,30,130,160,220,86,2,120,154,656
16,Adam Mokoka,25,0,168,19,47,7,25,12,22,2,5,8,7,15,9,6,1,7,22,47
17,Adam Morrison,31,0,241,32,85,5,21,27,64,5,8,10,22,32,18,3,2,10,17,74
18,Ade Murkey,1,0,1,0,0,0,0,0,0,0,0,0,0,0,0,0,0,0,0,0
19,Admiral Schofield,108,3,1288,144,343,69,214,75,129,43,53,47,151,198,71,20,14,44,169,400
20,Adonis Thomas,12,2,74,12,28,2,10,10,18,2,2,0,6,6,6,0,0,2,12,28
21,Adreian Payne,139,46,2142,265,649,16,68,249,581,96,143,127,350,477,96,64,36,134,291,642
22,Ahmad Caver,1,0,1,1,1,0,0,1,1,0,0,0,0,0,0,0,0,0,0,2
23,Al Harrington,253,19,6251,1176,2742,400,1170,776,1572,475,649,257,977,1234,337,177,49,391,682,3227
24,Al Horford,865,859,27737,5008,9758,754,2011,4254,7747,1241,1619,1615,5137,6752,3046,679,1016,1235,1785,12011
25,Al Jefferson,584,451,17112,4118,8298,8,49,4110,8249,1171,1623,1121,3743,4864,1009,415,684,688,1391,9415
26,Al Thornton,292,138,6924,1050,2214,30,114,1020,2100,526,706,344,670,1014,304,160,94,332,698,2656
27,Al-Farouq Aminu,734,459,18132,1986,4740,551,1671,1435,3069,929,1243,1004,3386,4390,910,697,406,891,1331,5452
28,Alan Anderson,277,59,5973,731,1822,302,885,429,937,352,431,117,495,612,318,164,27,236,521,2116
29,Alan Williams,67,0,872,163,322,0,2,163,320,87,139,115,256,371,39,37,38,51,155,413
30,Alando Tucker,30,0,192,34,78,2,14,32,64,32,42,12,8,20,8,0,0,10,12,102
31,Alec Burks,806,186,18630,2944,7043,940,2457,2004,4586,2027,2499,467,2418,2885,1695,577,178,982,1501,8855
32,Alec Peters,20,0,225,28,74,18,58,10,16,8,10,8,29,37,12,2,2,4,13,82
33,Aleem Ford,5,0,74,6,20,2,15,4,5,0,0,2,13,15,2,1,0,4,7,14
34,Aleksej Pokusevski,140,65,3024,433,1113,153,508,280,605,88,127,148,541,689,292,79,123,236,204,1107
35,Alen Smailagić,29,1,223,31,67,7,23,24,44,18,25,16,27,43,17,6,9,16,25,87
36,Alex Caruso,292,73,6206,612,1427,229,627,383,800,307,410,158,611,769,794,350,113,347,577,1760
37,Alex Kirk,5,0,14,1,4,0,0,1,4,2,2,1,0,1,1,0,0,0,1,4
38,Alex Len,715,291,12879,2046,3944,134,420,1912,3524,1049,1550,1280,2702,3982,600,271,673,801,1747,5275
39,Alex Poythress,52,2,566,76,161,19,53,57,108,26,39,47,75,122,24,10,13,18,77,197
40,Alex Stepheson,16,0,146,18,54,0,0,18,54,8,24,38,18,56,4,2,10,0,24,44
41,Alexey Shved,224,34,4038,578,1542,209,668,369,874,418,540,108,346,454,566,140,55,291,249,1783
42,Alexis Ajinça,296,74,4063,679,1347,24,74,655,1273,244,305,354,844,1198,150,106,194,255,700,1626
43,Alfonzo McKinnie,182,9,2113,287,615,84,258,203,357,63,108,154,300,454,57,51,27,71,266,721
44,Alize Johnson,99,1,735,93,197,5,26,88,171,39,57,105,184,289,41,20,10,44,74,230
45,Allen Crabbe,418,114,9778,1289,3065,653,1715,636,1350,394,476,120,1030,1150,467,238,108,302,811,3625
46,Allen Iverson*,56,48,1730,272,632,18,50,254,582,208,262,32,126,158,226,38,4,128,96,770
47,Allonzo Trier,88,4,1750,283,624,71,185,212,439,213,266,37,189,226,147,31,18,138,146,850
48,Alondes Williams,1,0,5,0,0,0,0,0,0,0,0,0,1,1,0,0,0,2,1,0
49,Alonzo Gee,527,249,10851,1209,2759,216,658,993,2101,692,920,488,1148,1636,504,454,126,535,944,3326
50,Alperen Şengün,147,85,3660,691,1324,48,174,643,1150,371,520,380,691,1071,476,129,138,338,472,1801
51,Amar'e Stoudemire,471,294,12651,2900,5426,16,58,2884,5368,1719,2244,991,2089,3080,500,270,453,919,1355,7535
52,Amida Brimah,5,0,29,5,8,0,0,5,8,3,3,2,6,8,1,0,5,4,4,13
53,Amile Jefferson,30,0,142,15,30,0,0,15,30,12,22,16,28,44,7,4,6,4,15,42
54,Amir Coffey,181,41,2745,335,768,136,369,199,399,183,229,57,253,310,213,60,22,89,187,989
55,Amir Johnson,735,461,16485,2344,4119,105,316,2239,3803,804,1199,1516,2668,4184,1018,475,682,847,2240,5597
56,Anderson Varejão,373,144,8402,1086,2131,1,28,1085,2103,492,722,871,1784,2655,517,293,216,356,821,2665
57,Andray Blatche,326,127,8227,1664,3551,37,145,1627,3406,739,1003,664,1328,1992,539,364,231,624,783,4104
58,Andre Dawkins,4,0,22,1,6,1,6,0,0,0,0,0,2,2,1,0,0,1,3,3
59,Andre Drummond,961,768,26676,5303,9828,20,163,5283,9665,1988,4051,4036,8022,12058,1413,1271,1292,1928,2907,12614
60,Andre Emmett,6,0,45,4,7,0,1,4,6,5,8,2,4,6,1,2,1,2,2,13
61,Andre Iguodala,827,380,24162,2848,6221,749,2255,2099,3966,1218,1857,658,3093,3751,3389,1038,446,1251,1239,7663
62,Andre Ingram,6,0,79,8,23,5,12,3,11,3,3,2,6,8,7,4,3,4,3,24
63,Andre Miller,667,177,14502,1957,4190,95,390,1862,3800,1155,1419,445,1250,1695,3072,507,71,1123,1080,5164
64,Andre Roberson,307,269,6801,573,1211,112,443,461,768,124,265,362,868,1230,265,268,199,185,658,1382
65,Andrea Bargnani,329,263,9863,1954,4368,318,951,1636,3417,902,1100,358,1224,1582,420,118,283,521,705,5128
66,Andrei Kirilenko,238,165,6607,863,1749,98,312,765,1437,634,877,335,772,1107,600,301,226,370,363,2458
67,Andrew Bogut,471,428,11995,1705,3204,2,11,1703,3193,357,698,1091,2950,4041,934,270,841,714,1413,3769
68,Andrew Bynum,231,210,6621,1261,2347,1,6,1260,2341,639,906,645,1403,2048,284,93,374,409,499,3162
69,Andrew Goudelock,49,0,475,77,196,29,84,48,112,14,16,7,27,34,24,10,2,28,36,197
70,Andrew Harrison,162,64,3174,330,895,100,348,230,547,306,389,58,249,307,423,99,51,190,400,1066
71,Andrew Nembhard,75,63,2073,284,644,92,263,192,381,49,62,35,164,199,341,70,13,126,179,709
72,Andrew Nicholson,323,36,4422,751,1628,92,298,659,1330,206,269,203,715,918,136,90,101,229,513,1800
73,Andrew White,15,0,209,25,73,18,49,7,24,1,4,4,30,34,6,3,1,8,12,69
74,Andrew Wiggins,689,689,23984,4971,11072,1037,2951,3934,8121,2348,3264,866,2243,3109,1676,685,480,1371,1532,13327
75,Andris Biedriņš,198,128,3439,273,489,0,0,273,489,20,84,289,742,1031,147,110,183,119,547,566
76,Andrés Nocioni,140,46,2464,357,884,139,373,218,511,126,171,52,353,405,121,47,42,119,264,979
77,Andy Rautins,5,0,24,3,7,1,4,2,3,1,2,0,1,1,3,1,0,7,0,8
78,Anfernee Simons,273,97,6546,1230,2842,596,1541,634,1301,394,460,86,531,617,673,117,38,358,492,3450
79,Antawn Jamison,351,237,10689,2047,4659,444,1298,1603,3361,856,1266,599,1711,2310,449,282,140,409,812,5394
80,Ante Žižić,113,27,1517,273,470,0,0,273,470,128,180,150,296,446,64,22,40,82,170,674
81,Anthony Bennett,151,4,1905,251,641,36,138,215,503,120,179,132,340,472,77,58,27,99,206,658
82,Anthony Brown,52,11,921,76,227,35,125,41,102,17,20,25,111,136,36,24,7,27,64,204
83,Anthony Carter,144,7,1994,183,446,46,160,137,286,35,39,36,188,224,332,101,29,153,190,447
84,Anthony Davis,660,653,22709,5917,11396,311,1038,5606,10358,3696,4661,1713,5152,6865,1562,883,1527,1301,1565,15841
85,Anthony Edwards,223,206,7622,1761,3997,599,1700,1162,2297,750,974,168,969,1137,836,312,140,609,479,4871
86,Anthony Gill,129,12,1305,163,301,25,79,138,222,104,135,86,149,235,72,22,27,41,155,455
87,Anthony Johnson,31,0,406,49,111,13,39,36,72,19,20,8,40,48,63,11,1,26,32,130
88,Anthony Lamb,88,7,1618,194,434,96,272,98,162,64,81,83,203,286,121,34,25,73,168,548
89,Anthony Morrow,587,133,11862,1863,4243,778,1929,1085,2314,582,658,254,823,1077,452,318,66,342,854,5086
90,Anthony Parker,204,197,5660,567,1353,244,626,323,727,184,246,73,514,587,495,168,35,201,325,1562
91,Anthony Randolph,229,24,3302,601,1327,21,83,580,1244,372,506,250,625,875,171,130,174,271,377,1595
92,Anthony Tolliver,888,158,17720,1866,4497,1061,2866,805,1631,827,1070,702,2383,3085,821,342,274,586,1494,5620
93,Antoine Wright,74,10,1423,163,407,58,177,105,230,53,77,40,153,193,71,31,11,59,137,437
94,Antonio Anderson,1,0,15,1,3,0,0,1,3,0,0,1,0,1,0,0,0,1,1,2
95,Antonio Blakeney,76,3,1143,219,539,51,143,168,396,80,115,11,128,139,62,19,10,46,60,569
96,Antonio Daniels,4,0,35,2,5,0,2,2,3,2,2,0,5,5,2,0,0,1,0,6
97,Antonio McDyess,150,66,3004,374,772,0,3,374,769,88,134,271,579,850,167,79,71,151,310,836
98,Antonius Cleveland,45,0,292,20,56,6,11,14,45,11,17,8,27,35,5,15,13,16,54,57
99,Anžejs Pasečņiks,28,0,443,61,117,0,4,61,113,34,58,43,65,108,19,9,12,29,77,156
100,Archie Goodwin,180,15,2610,403,922,50,206,353,716,294,415,93,266,359,230,73,43,220,200,1150
101,Arinze Onuaku,24,1,156,16,28,0,0,16,28,5,12,13,30,43,12,1,4,6,15,37
102,Armon Johnson,56,0,525,86,187,7,18,79,169,25,34,13,49,62,67,15,1,50,49,204
103,Armoni Brooks,128,27,2208,274,770,208,655,66,115,43,54,50,224,274,154,68,27,76,182,799
104,Arnett Moultrie,59,2,729,94,172,0,0,94,172,22,33,87,93,180,12,25,14,26,65,210
105,Arnoldas Kulboka,2,0,5,0,1,0,1,0,0,0,0,0,0,0,0,0,0,0,1,0
106,Aron Baynes,522,168,8370,1243,2543,111,360,1132,2183,518,652,805,1591,2396,421,118,255,445,1164,3115
107,Arron Afflalo,691,592,21127,3128,6976,917,2383,2211,4593,1421,1713,295,1857,2152,1419,323,127,891,1421,8594
108,Ashton Hagans,2,0,4,0,0,0,0,0,0,0,0,0,0,0,0,0,0,1,0,0
109,Austin Daye,404,34,5300,731,1827,265,741,466,1086,237,307,174,815,989,279,146,148,261,619,1964
110,Austin Reaves,125,41,3261,405,808,139,383,266,425,328,383,78,308,386,325,62,39,139,195,1277
111,Austin Rivers,895,211,21294,2753,6602,987,2867,1766,3735,936,1445,282,1556,1838,1916,619,151,901,1896,7429
112,Avery Bradley,796,659,22091,3485,8119,1053,2902,2432,5217,710,903,470,1741,2211,1397,768,155,1086,1741,8733
113,Axel Toupane,37,1,460,39,99,16,50,23,49,18,24,8,31,39,19,11,11,6,58,112
114,Ayo Dosunmu,157,91,4208,559,1105,129,375,430,730,119,160,72,362,434,462,122,55,207,364,1366
115,B.J. Johnson,28,0,246,38,93,13,33,25,60,13,14,13,33,46,3,7,1,10,15,102
116,Bam Adebayo,418,314,12264,2358,4259,8,62,2350,4197,1422,1883,922,2616,3538,1429,428,370,895,1047,6146
117,Baron Davis,220,175,6416,1058,2585,270,859,788,1726,457,577,135,499,634,1515,316,102,579,557,2843
118,Ben Bentil,3,0,10,0,3,0,1,0,2,0,0,0,2,2,0,0,0,1,1,0
119,Ben Gordon,346,65,7888,1340,3162,401,1065,939,2097,631,741,108,547,655,676,190,52,586,651,3712
120,Ben Hansbrough,28,0,200,15,45,6,23,9,22,21,27,2,16,18,21,7,2,18,23,57
121,Ben McLemore,609,272,13439,1903,4635,965,2672,938,1963,650,836,237,1132,1369,602,376,115,650,1263,5421
122,Ben Moore,2,0,9,0,0,0,0,0,0,0,0,0,1,1,1,0,0,0,4,0
123,Ben Simmons,317,308,10431,1917,3423,5,36,1912,3387,834,1411,563,1917,2480,2383,518,223,1022,916,4673
124,Ben Uzoh,78,16,1178,131,342,3,10,128,332,55,94,68,127,195,191,47,14,63,91,320
125,Ben Wallace*,185,127,4193,259,527,2,8,257,519,100,264,455,761,1216,220,187,189,142,272,620
126,Bennedict Mathurin,78,17,2222,413,951,100,310,313,641,376,454,87,231,318,116,48,13,152,162,1302
127,Beno Udrih,637,169,13959,2059,4403,330,945,1729,3458,727,866,235,1095,1330,2404,435,44,895,915,5175
128,Bernard James,92,13,761,76,153,0,3,76,150,51,75,85,127,212,13,17,61,34,105,203
129,Billy Garrett,4,0,63,11,27,0,8,11,19,4,4,0,3,3,7,1,1,2,3,26
130,Bismack Biyombo,799,324,15593,1579,2960,0,3,1579,2957,919,1654,1544,3198,4742,498,206,1040,724,1733,4077
131,Blake Ahearn,4,0,30,4,14,2,9,2,5,0,0,0,2,2,1,0,0,5,4,10
132,Blake Griffin,869,780,27540,6029,12395,719,2166,5310,10229,3483,4955,1595,5167,6762,3529,700,392,1959,2308,16260
133,Blake Wesley,37,1,669,69,215,20,52,49,163,26,44,11,70,81,99,25,5,65,67,184
134,Boban Marjanović,414,38,3829,921,1585,14,50,907,1535,591,772,530,1036,1566,224,85,132,300,480,2447
135,Bobby Brown,135,0,1276,218,592,77,271,141,321,29,34,18,71,89,201,35,2,106,95,542
136,Bobby Portis,573,170,12954,2702,5739,647,1692,2055,4047,667,879,1113,2957,4070,714,327,207,642,1128,6718
137,Bobby Simmons,53,2,829,70,210,40,126,30,84,22,27,28,90,118,28,30,6,29,95,202
138,Bogdan Bogdanović,370,161,10549,1924,4371,888,2294,1036,2077,521,633,169,1079,1248,1223,368,91,533,764,5257
139,Bojan Bogdanović,743,599,21495,3939,8588,1522,3889,2417,4699,2029,2339,396,2288,2684,1208,402,57,1235,1236,11429
140,Bol Bol,123,35,1833,315,591,44,150,271,441,102,138,78,390,468,87,36,103,139,121,776
141,Bones Hyland,181,6,3480,686,1713,365,988,321,725,279,329,54,404,458,535,119,50,250,345,2016
142,Bonzie Colson,8,2,98,13,39,5,21,8,18,8,9,8,22,30,3,5,1,3,3,39
143,Boris Diaw,662,330,16868,2186,4503,380,1139,1806,3364,510,701,698,2019,2717,2053,378,265,1083,1275,5262
144,Brad Miller,157,43,3111,391,904,84,254,307,650,270,326,131,509,640,323,76,52,173,297,1136
145,Brad Wanamaker,275,5,4458,498,1219,93,345,405,874,376,416,73,400,473,693,173,50,283,445,1465
146,Bradley Beal,695,661,24091,5624,12235,1514,4070,4110,8165,2629,3196,601,2236,2837,2972,772,284,1708,1542,15391
147,Brandan Wright,491,43,8094,1431,2319,0,11,1431,2308,464,695,678,1131,1809,235,244,503,222,632,3326
148,Branden Dawson,6,0,29,2,5,0,0,2,5,1,1,2,2,4,0,0,1,0,2,5
149,Brandon Bass,548,278,12849,2017,4010,12,47,2005,3963,1079,1298,859,1764,2623,501,241,366,529,1051,5125
150,Brandon Boston Jr.,73,1,1008,176,447,46,140,130,307,88,110,24,117,141,71,35,13,43,64,486
151,Brandon Clarke,237,29,5051,1069,1770,49,169,1020,1601,347,492,416,909,1325,334,165,204,177,437,2534
152,Brandon Davies,105,12,1421,164,402,18,78,146,324,82,127,114,161,275,88,60,22,93,210,428
153,Brandon Goodwin,133,11,1609,230,590,79,251,151,339,89,122,34,177,211,251,54,5,104,130,628
154,Brandon Ingram,413,374,13618,2873,6191,558,1535,2315,4656,1620,2067,301,1841,2142,1674,292,229,1036,1008,7924
155,Brandon Jennings,684,449,19514,3054,7938,1044,3055,2010,4883,1558,1973,374,1577,1951,3716,778,109,1388,1169,8710
156,Brandon Knight,578,439,16435,2793,6814,926,2610,1867,4204,1308,1612,278,1451,1729,2247,507,90,1347,1105,7820
157,Brandon Paul,64,2,576,55,127,15,54,40,73,22,43,6,62,68,37,25,7,29,58,147
158,Brandon Roy,117,93,3851,711,1596,111,344,600,1252,467,588,104,316,420,457,101,28,191,217,2000
159,Brandon Rush,406,144,8761,977,2286,444,1091,533,1195,242,342,153,1027,1180,402,184,225,325,492,2640
160,Brandon Sampson,14,2,214,28,60,11,29,17,31,4,6,3,13,16,10,8,3,12,19,71
161,Brandon Williams,24,16,640,105,282,31,106,74,176,68,97,19,55,74,94,24,10,58,52,309
162,Braxton Key,25,0,403,67,145,12,42,55,103,16,28,26,75,101,22,20,22,22,52,162
163,Brendan Haywood,363,214,8468,905,1679,0,4,905,1675,450,842,955,1494,2449,155,110,503,355,827,2260
164,Brian Bowen,12,1,46,4,14,0,3,4,11,1,1,1,9,10,0,0,1,1,4,9
165,Brian Cardinal,129,4,1162,71,191,55,145,16,46,39,42,21,101,122,80,41,12,32,176,236
166,Brian Cook,119,0,1043,141,389,56,188,85,201,38,51,40,191,231,36,24,23,53,176,376
167,Brian Roberts,365,59,5677,827,1996,232,652,595,1344,378,417,64,399,463,775,142,21,295,403,2264
168,Brian Scalabrine,98,3,682,53,134,17,61,36,73,7,12,18,59,77,48,17,14,31,86,130
169,Brian Skinner,19,1,133,10,26,0,0,10,26,6,8,9,18,27,0,3,4,7,21,26
170,Briante Weber,90,8,1222,116,284,10,52,106,232,44,60,48,124,172,128,78,18,64,112,286
171,Brice Johnson,39,0,205,42,91,0,2,42,89,6,10,19,46,65,5,20,13,11,26,90
172,Brodric Thomas,76,2,858,86,234,34,127,52,107,65,97,18,98,116,71,31,21,50,87,271
173,Brook Lopez,864,831,26064,5472,11074,788,2276,4684,8798,2686,3376,1706,3556,5262,1259,496,1572,1441,2249,14418
174,Bruce Brown,349,212,8588,1172,2431,203,596,969,1835,432,577,383,1098,1481,841,325,196,379,851,2979
175,Bruno Caboclo,147,20,1644,209,522,71,251,138,271,69,82,112,238,350,88,54,80,86,174,558
176,Bruno Fernando,227,21,2054,311,577,7,51,304,526,144,221,227,433,660,135,36,110,141,326,773
177,Bryce Cotton,31,0,237,37,89,7,26,30,63,15,18,3,15,18,21,10,0,22,10,96
178,Bryce Dejean-Jones,14,11,279,28,69,12,32,16,37,11,21,8,40,48,15,10,2,11,17,79
179,Bryce McGowens,46,7,787,80,202,26,80,54,122,60,80,20,73,93,54,15,6,43,48,246
180,Bryn Forbes,506,169,9868,1590,3658,842,2052,748,1606,417,496,79,732,811,598,188,19,353,689,4439
181,Buddy Boeheim,10,0,90,5,27,4,25,1,2,2,2,2,4,6,4,2,0,0,6,16
182,Buddy Hield,711,456,20544,3961,9215,2115,5335,1846,3880,901,1049,516,2509,3025,1755,586,196,1215,1444,10938
183,Byron Mullens,234,66,3860,630,1531,144,437,486,1094,183,265,224,658,882,167,89,109,214,399,1587
184,C.J. Miles,710,206,15252,2556,6337,1212,3382,1344,2955,989,1220,286,1502,1788,749,531,240,626,1506,7313
185,C.J. Watson,491,86,9842,1216,2954,414,1117,802,1837,650,814,166,766,932,1244,448,63,540,738,3496
186,C.J. Wilcox,66,0,376,50,135,19,57,31,78,13,16,6,25,31,30,15,4,18,30,132
187,C.J. Williams,53,17,835,104,232,27,94,77,138,13,17,13,51,64,55,37,13,25,79,248
188,CJ Elleby,88,28,1366,146,374,44,160,102,214,71,99,77,182,259,97,41,22,61,143,407
189,CJ McCollum,727,630,23418,5479,12075,1761,4464,3718,7611,1560,1965,480,2158,2638,2788,666,283,1337,1528,14279
190,Cade Cunningham,76,76,2488,522,1255,131,424,391,831,178,211,70,358,428,428,88,50,273,234,1353
191,Caleb Houstan,51,4,812,66,182,46,136,20,46,15,18,34,65,99,30,12,7,18,63,193
192,Caleb Martin,202,65,4584,595,1298,199,553,396,745,220,291,199,554,753,271,178,80,178,343,1609
193,Caleb Swanigan,123,5,1121,116,260,3,26,113,234,42,70,103,279,382,98,23,19,128,217,277
194,Cam Reddish,262,109,6305,917,2257,338,1032,579,1225,498,582,143,563,706,332,267,95,338,464,2670
195,Cam Thomas,124,6,2124,419,959,98,307,321,652,238,279,24,232,256,156,53,15,118,121,1174
196,Cameron Bairstow,36,3,167,16,54,1,5,15,49,11,13,10,26,36,7,4,4,7,27,44
197,Cameron Johnson,267,118,6820,1104,2443,595,1508,509,935,396,470,192,837,1029,410,230,80,193,452,3199
198,Cameron McGriff,3,0,46,5,14,2,6,3,8,2,2,6,9,15,3,0,1,0,7,14
199,Cameron Oliver,6,0,130,29,48,5,16,24,32,3,7,7,20,27,8,3,5,3,16,66
200,Cameron Payne,398,69,7136,1173,2828,402,1133,771,1695,287,354,115,735,850,1280,263,84,483,680,3035
201,Cameron Reynolds,29,0,339,45,114,27,75,18,39,8,9,8,33,41,17,6,2,5,30,125
202,Caris LeVert,497,298,14264,2805,6408,731,2155,2074,4253,1139,1526,365,1561,1926,2037,532,184,935,1050,7480
203,Carl Landry,558,148,13823,2555,4879,9,33,2546,4846,1688,2145,1127,1671,2798,424,268,260,754,1374,6807
204,Carldell Johnson,15,0,119,11,35,4,15,7,20,1,3,1,8,9,22,8,0,7,11,27
205,Carlik Jones,17,0,102,8,33,3,8,5,25,9,12,3,8,11,16,4,0,8,2,28
206,Carlos Arroyo,200,121,3955,418,921,69,163,349,758,154,184,66,270,336,475,78,8,174,244,1059
207,Carlos Boozer,429,384,12882,2858,5648,0,5,2858,5643,986,1372,848,3040,3888,909,352,140,898,1263,6702
208,Carlos Delfino,245,164,7095,932,2318,483,1309,449,1009,239,298,113,909,1022,572,303,48,314,423,2586
209,Carmelo Anthony,892,752,30152,6939,15738,1517,4117,5422,11621,4096,4936,1228,4413,5641,2276,788,491,1883,2433,19491
210,Caron Butler,525,366,14820,2274,5440,614,1677,1660,3763,949,1138,383,1786,2169,767,509,115,690,1086,6111
211,Carrick Felix,7,0,38,7,14,2,5,5,9,3,4,1,5,6,4,0,0,4,4,19
212,Carsen Edwards,72,1,706,98,269,46,155,52,114,25,33,11,68,79,52,21,5,27,63,267
213,Cartier Martin,287,22,4345,563,1421,284,753,279,668,203,277,119,489,608,157,127,31,172,403,1613
214,Casper Ware,9,0,116,18,42,7,21,11,21,5,6,0,9,9,10,8,0,5,11,48
215,Cassius Stanley,33,1,248,32,89,7,30,25,59,17,19,13,26,39,5,6,4,7,31,88
216,Cassius Winston,29,0,137,18,44,10,23,8,21,9,10,0,10,10,19,2,1,8,17,55
217,Cat Barber,3,0,13,0,4,0,0,0,4,0,4,1,2,3,3,0,0,1,1,0
218,Cedi Osman,404,183,9546,1421,3327,628,1777,793,1550,468,655,191,1040,1231,814,276,60,436,801,3938
219,Cedric Jackson,24,0,148,12,40,2,12,10,28,14,24,4,12,16,28,6,4,22,14,40
220,Chance Comanche,1,0,21,3,5,0,0,3,5,1,4,2,1,3,0,0,1,0,0,7
221,Chandler Hutchison,128,26,2136,255,592,42,132,213,460,113,168,61,393,454,96,74,23,96,173,665
222,Chandler Parsons,440,369,13246,2129,4611,687,1844,1442,2767,626,878,356,1616,1972,1201,412,152,657,865,5571
223,Channing Frye,735,384,16111,2250,5165,1159,2986,1091,2179,537,636,437,2671,3108,772,392,449,570,1721,6196
224,Charles Bassey,58,2,676,117,182,3,12,114,170,31,49,97,158,255,54,21,50,49,106,268
225,Charles Cooke,13,0,38,2,14,1,8,1,6,1,2,0,2,2,1,1,0,1,0,6
226,Charles Jenkins,169,30,1775,228,533,5,24,223,509,58,83,24,108,132,258,63,10,102,129,519
227,Charlie Bell,90,39,1782,181,486,79,221,102,265,50,71,37,113,150,117,45,13,60,149,491
228,Charlie Brown Jr.,63,5,547,39,140,10,54,29,86,32,35,33,52,85,23,26,12,19,58,120
229,Charlie Villanueva,382,32,6309,1196,2871,473,1358,723,1513,278,375,253,1031,1284,210,165,183,252,670,3143
230,Chase Budinger,473,52,8927,1292,3005,437,1258,855,1747,448,569,281,1109,1390,537,245,75,354,547,3469
231,Chasson Randle,145,7,2218,263,654,122,341,141,313,168,202,29,175,204,244,67,12,127,236,816
232,Chauncey Billups,278,266,8444,1240,2989,544,1396,696,1593,1374,1505,85,633,718,1354,253,42,620,535,4398
233,Chaundee Brown Jr.,10,4,208,20,64,12,36,8,28,10,12,2,30,32,8,4,0,2,14,62
234,Cheick Diallo,183,3,2186,401,673,2,7,399,666,154,199,179,580,759,78,56,73,117,273,958
235,Chima Moneke,2,0,8,1,2,0,0,1,2,0,2,2,0,2,1,0,0,2,2,2
236,Chimezie Metu,209,26,2706,466,947,79,265,387,682,179,237,133,581,714,151,96,79,147,254,1190
237,Chinanu Onuaku,6,1,74,7,12,0,0,7,12,4,4,3,11,14,4,3,1,7,10,18
238,Chris Andersen,393,51,6983,736,1267,17,63,719,1204,619,915,613,1314,1927,167,193,482,241,719,2108
239,Chris Babb,14,0,132,8,30,6,27,2,3,0,0,4,13,17,3,6,0,3,13,22
240,Chris Bosh*,454,454,15647,3195,6393,263,764,2932,5629,1939,2414,763,2812,3575,846,376,400,850,1000,8592
241,Chris Boucher,307,23,5649,992,2042,270,809,722,1233,534,685,576,1077,1653,145,159,335,164,628,2788
242,Chris Chiozza,119,6,1439,167,457,86,244,81,213,25,30,31,139,170,300,63,15,113,127,445
243,Chris Clemons,33,0,291,57,142,37,107,20,35,10,11,4,26,30,27,9,6,19,26,161
244,Chris Copeland,171,26,2111,366,858,154,422,212,436,112,149,65,207,272,107,32,30,129,237,998
245,Chris Douglas-Roberts,178,58,3796,493,1133,81,243,412,890,288,346,69,353,422,202,116,48,169,253,1355
246,Chris Duarte,101,51,2438,391,954,149,429,242,525,151,184,60,281,341,178,81,19,131,160,1082
247,Chris Duhon,227,82,4892,349,906,186,520,163,386,105,154,62,338,400,780,130,15,292,240,989
248,Chris Hunter,60,9,783,109,217,0,4,109,213,52,69,56,111,167,37,13,35,30,132,270
249,Chris Johnson,288,8,3710,398,940,132,434,266,506,181,231,153,401,554,126,140,102,158,413,1109
250,Chris Kaman,350,204,8427,1824,3730,1,14,1823,3716,551,729,631,1771,2402,452,137,366,703,783,4200
251,Chris McCullough,75,4,612,94,215,16,56,78,159,26,47,50,81,131,17,32,21,23,61,230
252,Chris Paul,914,914,30616,5643,11938,1386,3703,4257,8235,3256,3699,495,3529,4024,8535,1818,171,2112,2157,15928
253,Chris Quinn,73,0,593,57,163,21,74,36,89,12,16,5,38,43,80,17,2,28,48,147
254,Chris Richard,18,0,224,15,29,0,0,15,29,7,11,19,40,59,7,8,4,14,50,37
255,Chris Silva,95,0,715,85,141,2,5,83,136,79,109,100,152,252,49,11,35,69,175,251
256,Chris Singleton,148,62,2605,233,620,58,182,175,438,88,139,112,360,472,92,117,57,100,325,612
257,Chris Smith,2,0,2,0,0,0,0,0,0,0,0,0,0,0,0,0,0,0,0,0
258,Chris Wilcox,180,50,2747,424,702,0,2,424,700,139,238,232,458,690,90,85,66,145,398,987
259,Chris Wright,35,1,316,45,82,0,1,45,81,30,46,29,36,65,9,14,18,14,39,120
260,Christian Braun,76,6,1181,143,289,34,96,109,193,40,64,48,133,181,59,41,17,35,101,360
261,Christian Eyenga,58,18,1151,142,356,27,97,115,259,26,44,35,116,151,45,40,38,53,92,337
262,Christian Koloko,58,19,802,72,150,1,12,71,138,37,59,84,87,171,31,21,57,20,128,182
263,Christian Wood,310,141,7237,1609,3105,389,1029,1220,2076,835,1201,438,1757,2195,428,174,272,454,582,4442
264,Chuck Hayes,437,157,7887,697,1460,0,7,697,1453,234,358,711,1365,2076,622,297,155,331,877,1628
265,Chucky Atkins,40,11,644,57,157,22,73,35,84,25,27,5,24,29,91,17,0,32,53,161
266,Chuma Okeke,142,47,3400,394,1021,193,598,201,423,101,126,115,509,624,256,164,75,112,183,1082
267,Cleanthony Early,56,9,801,88,254,26,99,62,155,39,52,26,97,123,42,26,15,49,73,241
268,Cliff Alexander,8,0,36,5,10,0,0,5,10,0,0,2,4,6,0,1,2,1,1,10
269,Clint Capela,536,473,14344,2899,4620,0,4,2899,4616,832,1560,1923,3817,5740,523,373,792,583,1288,6630
270,Coby Karl,14,2,226,22,64,4,22,18,42,8,12,8,28,36,30,6,2,20,28,56
271,Coby White,269,74,7235,1229,2932,560,1527,669,1405,369,432,89,819,908,883,170,38,409,555,3387
272,Cody Martin,178,24,3752,390,854,98,308,292,546,146,222,180,448,628,371,168,54,147,259,1024
273,Cody Zeller,509,275,11190,1623,3110,32,147,1591,2963,1022,1400,1019,1994,3013,701,323,325,536,1314,4300
274,Cole Aldrich,384,23,3777,479,905,0,0,479,905,192,264,364,887,1251,192,142,256,222,569,1150
275,Cole Anthony,172,103,4884,853,2074,265,769,588,1305,477,554,117,740,857,796,113,66,367,427,2448
276,Cole Swider,7,0,41,3,9,3,8,0,1,0,0,1,6,7,4,0,0,0,3,9
277,Collin Sexton,266,223,8324,1862,4016,373,982,1489,3034,944,1143,226,542,768,858,208,29,626,622,5041
278,Corey Brewer,1059,340,23239,3343,7818,656,2345,2687,5473,1574,2210,751,2063,2814,1577,1318,270,1189,2210,8916
279,Corey Kispert,151,81,3894,525,1099,275,704,250,395,129,150,86,330,416,172,67,31,105,190,1454
280,Corey Maggette,187,95,4620,876,1894,70,215,806,1679,945,1132,162,602,764,314,101,12,371,531,2767
281,Cory Higgins,44,0,455,58,179,5,25,53,154,43,62,8,30,38,41,8,6,39,45,164
282,Cory Jefferson,58,1,581,84,189,2,16,82,173,35,60,53,108,161,16,10,22,20,69,205
283,Cory Joseph,853,188,18834,2343,5269,518,1484,1825,3785,901,1141,425,1724,2149,2616,657,194,899,1419,6105
284,Coty Clarke,3,0,6,2,4,2,2,0,2,0,0,0,1,1,0,0,0,1,0,6
285,Courtney Fortson,20,0,190,22,64,6,26,16,38,20,30,12,18,30,20,6,0,20,10,70
286,Courtney Lee,926,594,24734,3356,7409,964,2522,2392,4887,1101,1291,413,1982,2395,1550,904,258,852,1475,8777
287,Craig Brackins,17,1,121,13,49,3,14,10,35,1,2,7,12,19,9,1,1,4,9,30
288,Craig Smith,170,2,2282,389,702,1,11,388,691,220,329,173,341,514,134,65,37,145,333,999
289,Craig Sword,3,0,19,3,4,0,1,3,3,0,0,0,0,0,1,4,0,1,7,6
290,Cristiano Felício,252,20,3554,431,754,0,14,431,740,216,321,381,611,992,183,72,50,155,358,1078
291,D'Angelo Russell,611,547,18537,3972,9227,1589,4337,2383,4890,1536,1933,306,1804,2110,3529,659,190,1715,1156,11069
292,D.J. Augustin,1231,359,28036,3660,8929,1589,4192,2071,4737,2406,2781,349,1871,2220,4670,710,42,1784,1630,11315
293,D.J. Kennedy,2,0,59,5,12,2,4,3,8,0,2,1,6,7,3,2,0,3,7,12
294,D.J. Mbenga,90,2,685,71,152,0,0,71,152,22,37,67,106,173,14,11,56,36,106,164
295,D.J. Stephens,4,0,22,4,9,0,0,4,9,1,1,1,4,5,0,1,0,1,0,9
296,D.J. White,178,11,2666,433,856,1,5,432,851,149,208,150,413,563,93,48,72,76,266,1016
297,D.J. Wilson,181,7,2236,312,750,126,381,186,369,80,127,100,464,564,131,51,59,101,219,830
298,DaJuan Summers,83,7,820,103,268,29,79,74,189,43,67,24,58,82,29,18,8,37,104,278
299,DaQuan Jeffries,78,10,1136,121,282,45,153,76,129,19,22,41,121,162,52,34,21,30,116,306
300,Daequan Cook,243,27,3160,371,1064,236,690,135,374,69,91,43,355,398,116,66,36,87,222,1047
301,Dahntay Jones,377,69,5742,681,1605,74,254,607,1351,536,687,126,505,631,347,131,71,284,694,1972
302,Dairis Bertāns,12,0,167,12,47,10,34,2,13,0,0,2,7,9,10,1,0,2,7,34
303,Daishen Nix,81,7,1175,108,304,47,166,61,138,40,66,25,106,131,172,46,7,112,80,303
304,Dakari Johnson,31,6,161,22,39,0,0,22,39,11,20,16,18,34,8,6,8,3,27,55
305,Dakota Mathias,14,2,139,21,54,10,32,11,22,2,6,1,8,9,14,2,3,1,8,54
306,Dalano Banton,95,3,975,138,332,28,102,110,230,43,68,49,120,169,135,41,23,71,102,347
307,Dalen Terry,38,0,214,32,72,7,27,25,45,14,21,12,25,37,22,11,5,8,24,85
308,Damian Jones,320,86,4536,618,934,34,82,584,852,314,441,350,700,1050,222,104,219,211,635,1584
309,Damian Lillard,769,769,27942,6281,14299,2387,6410,3894,7889,4427,4946,469,2784,3253,5151,732,239,2186,1477,19376
310,Damien Inglis,20,1,156,13,37,3,13,10,24,7,8,2,29,31,10,6,3,11,11,36
311,Damien Wilkins,272,55,4430,468,1066,48,163,420,903,261,352,154,406,560,320,161,66,181,406,1245
312,Damion James,39,17,623,61,147,0,6,61,141,28,42,25,106,131,26,23,20,38,56,150
313,Damion Lee,290,58,6043,828,1899,377,995,451,904,351,400,139,843,982,410,189,28,238,471,2384
314,Damjan Rudež,146,2,1638,175,413,106,284,69,129,24,31,18,74,92,84,31,7,69,143,480
315,Damyean Dotson,213,49,4242,603,1446,253,733,350,713,135,190,58,474,532,315,109,20,151,255,1594
316,Dan Gadzuric,118,24,1253,147,349,0,2,147,347,30,81,181,186,367,40,36,72,74,249,324
317,Daniel Gafford,301,129,5239,976,1390,0,1,976,1389,410,616,558,850,1408,231,128,404,261,651,2362
318,Daniel Gibson,204,35,4768,560,1423,300,744,260,679,228,292,53,358,411,429,129,48,192,391,1648
319,Daniel Hamilton,25,3,232,28,71,10,28,18,43,3,6,10,42,52,30,7,1,18,21,69
320,Daniel Ochefu,19,0,75,12,27,0,0,12,27,0,2,5,17,22,3,2,0,3,17,24
321,Daniel Orton,51,6,542,50,103,0,1,50,102,43,72,48,78,126,24,18,28,29,81,143
322,Daniel Oturu,33,0,188,25,58,1,6,24,52,12,17,22,31,53,10,4,9,9,25,63
323,Daniel Theis,425,226,8675,1340,2483,242,750,1098,1733,455,647,628,1487,2115,542,212,356,370,1100,3377
324,Danilo Gallinari,762,621,23472,3663,8591,1497,3953,2166,4638,3304,3777,547,3213,3760,1503,573,285,953,1401,12127
325,Danny Granger,320,213,9484,1721,4151,556,1518,1165,2633,1171,1364,318,1111,1429,585,284,194,593,737,5169
326,Danny Green,841,709,21019,2568,6094,1593,3982,975,2112,536,666,504,2335,2839,1282,858,637,835,1469,7265
327,Dante Cunningham,866,238,18074,2154,4613,275,807,1879,3806,449,689,978,2273,3251,597,552,409,436,1515,5032
328,Dante Exum,280,73,5030,565,1371,182,590,383,781,236,310,103,405,508,555,114,52,339,467,1548
329,Danuel House Jr.,302,110,6489,767,1785,397,1091,370,694,328,431,158,774,932,351,171,110,228,473,2259
330,Darington Hobson,5,0,39,2,13,0,6,2,7,0,0,0,3,3,6,0,0,2,1,4
331,Dario Šarić,551,270,12600,2055,4643,720,1986,1335,2657,932,1106,770,2187,2957,974,305,102,780,1135,5762
332,Darius Bazley,271,119,6000,838,2022,252,802,586,1220,361,550,220,1134,1354,313,154,204,311,271,2289
333,Darius Days,4,0,25,5,12,3,10,2,2,2,2,1,5,6,1,0,1,0,2,15
334,Darius Garland,250,246,8491,1706,3803,553,1428,1153,2375,667,766,117,532,649,1679,282,26,762,465,4632
335,Darius Johnson-Odom,7,0,21,0,11,0,4,0,7,0,2,1,5,6,2,1,0,2,3,0
336,Darius Miller,271,28,5358,545,1300,344,898,201,402,163,194,51,396,447,367,123,66,171,523,1597
337,Darius Morris,159,17,1777,205,528,59,184,146,344,68,107,47,105,152,233,58,2,139,160,537
338,Darius Songaila,85,1,1481,248,503,1,6,247,497,62,78,61,181,242,72,62,14,85,222,559
339,Darko Miličić,163,128,3533,530,1117,0,2,530,1115,110,208,262,498,760,215,107,233,255,453,1170
340,Darnell Jackson,115,2,732,95,218,5,19,90,199,38,61,67,71,138,22,16,11,49,103,233
341,Darrell Arthur,427,42,7481,1190,2674,161,456,1029,2218,319,409,439,983,1422,366,257,255,375,1028,2860
342,Darren Collison,711,518,20833,3272,6944,635,1613,2637,5331,1682,1973,332,1557,1889,3545,820,106,1383,1212,8861
343,Darrun Hilliard,91,3,859,104,276,31,102,73,174,56,75,7,78,85,71,22,3,51,74,295
344,Darryl Watkins,5,0,98,7,14,0,0,7,14,9,18,8,19,27,3,5,4,8,14,23
345,Daryl Macon,12,0,104,11,30,6,13,5,17,4,7,2,10,12,8,1,0,8,9,32
346,David Andersen,143,0,1637,259,582,43,124,216,458,74,111,94,282,376,70,25,30,81,199,635
347,David Duke Jr.,45,7,569,75,186,10,49,65,137,29,38,41,55,96,38,24,8,27,67,189
348,David Johnson,2,0,2,0,1,0,1,0,0,0,0,0,0,0,0,0,0,0,0,0
349,David Lee,597,381,17156,3525,6702,1,25,3524,6677,1473,1896,1448,3597,5045,1493,434,263,1130,1535,8524
350,David Nwaba,237,50,4583,603,1231,87,272,516,959,329,489,236,630,866,246,177,106,163,447,1622
351,David Roddy,70,4,1258,180,420,65,212,115,208,41,65,50,143,193,59,29,19,57,107,466
352,David Stockton,6,0,42,4,9,3,5,1,4,7,10,0,2,2,9,2,0,5,4,18
353,David Wear,2,0,7,0,2,0,1,0,1,0,0,2,0,2,1,0,0,0,1,0
354,David West,655,455,17384,3374,6694,32,122,3342,6572,1427,1787,993,2878,3871,1634,511,537,1044,1457,8207
355,Davion Mitchell,155,28,3523,533,1242,164,517,369,725,81,116,49,222,271,498,99,39,176,253,1311
356,Davon Reed,165,8,1641,164,417,84,220,80,197,50,75,38,233,271,115,65,19,67,161,462
357,Day'Ron Sharpe,80,11,943,179,320,8,18,171,302,59,96,180,180,360,54,25,47,72,149,425
358,De'Aaron Fox,395,380,12761,2951,6247,483,1506,2468,4741,1589,2159,209,1235,1444,2452,515,165,1081,1026,7974
359,De'Andre Hunter,206,200,6399,1033,2328,313,880,720,1448,481,602,133,723,856,318,134,68,283,595,2860
360,De'Anthony Melton,312,113,7003,991,2396,452,1221,539,1175,314,407,231,924,1155,857,435,154,439,626,2748
361,DeAndre Jordan,1083,860,28678,3992,5934,2,13,3990,5921,1882,3806,3289,7984,11273,1132,592,1574,1528,2696,9868
362,DeAndre Liggins,297,47,3408,224,569,79,221,145,348,72,127,74,361,435,224,192,59,148,363,599
363,DeAndre' Bembry,352,75,6696,844,1740,121,411,723,1329,225,369,227,886,1113,599,340,145,398,646,2034
364,DeJon Jarreau,1,0,1,0,0,0,0,0,0,0,0,0,0,0,0,0,0,0,0,0
365,DeJuan Blair,424,179,7054,1242,2371,0,9,1242,2362,381,627,810,1343,2153,349,316,127,471,1003,2865
366,DeMar DeRozan,1031,1019,35471,7790,16652,456,1566,7334,15086,5649,6725,742,3828,4570,4106,1018,316,2139,2348,21685
367,DeMarcus Cousins,815,651,23404,5488,11985,641,1908,4847,10077,3923,5287,1971,6020,7991,2458,1043,880,2567,2945,15540
368,DeMarre Carroll,638,348,14363,1878,4387,673,1891,1205,2496,925,1248,697,1873,2570,773,545,158,526,1201,5354
369,DeQuan Jones,63,17,803,95,218,9,35,86,183,34,51,17,88,105,16,19,22,30,55,233
370,DeSagana Diop,92,10,994,46,122,0,1,46,121,7,27,79,162,241,48,20,58,50,112,99
371,DeShawn Stevenson,307,151,5042,367,1090,249,777,118,313,104,152,67,444,511,282,101,27,146,347,1087
372,DeVaughn Akoon-Purcell,7,0,22,3,10,0,4,3,6,1,2,1,3,4,6,2,0,2,4,7
373,Dean Wade,170,60,3154,315,718,176,486,139,232,65,93,92,442,534,165,94,53,66,263,871
374,Deandre Ayton,303,296,9282,2213,3709,21,80,2192,3629,599,793,919,2233,3152,495,205,299,520,854,5046
375,Deividas Sirvydis,23,0,160,15,50,11,35,4,15,3,6,0,35,35,6,5,1,5,13,44
376,Dejounte Murray,394,323,10950,2240,4896,351,1048,1889,3848,677,863,376,1933,2309,1988,567,103,754,702,5508
377,Delon Wright,599,136,13245,1700,3751,431,1238,1269,2513,788,982,513,1520,2033,1966,755,225,601,683,4619
378,Delonte West,128,38,3013,415,916,64,186,351,730,190,227,48,259,307,399,133,49,196,182,1084
379,Demetrius Jackson,41,0,216,25,55,5,21,20,34,9,14,14,17,31,26,12,2,21,18,64
380,Deng Adel,19,3,194,11,36,6,23,5,13,4,4,3,16,19,5,1,4,6,13,32
381,Deni Avdija,212,80,5261,633,1470,204,659,429,811,254,346,148,1026,1174,441,156,88,243,539,1724
382,Dennis Horner,8,0,22,1,4,0,1,1,3,3,4,2,3,5,0,0,0,1,1,5
383,Dennis Schröder,751,346,20270,3869,8921,881,2611,2988,6310,1884,2250,321,1887,2208,3501,618,100,1734,1562,10503
384,Dennis Smith Jr.,346,209,8470,1413,3466,324,1063,1089,2403,517,780,206,807,1013,1507,399,131,745,723,3667
385,Denzel Valentine,280,45,5039,705,1794,380,1051,325,743,74,94,110,789,899,477,167,31,240,432,1864
386,Deonte Burton,73,0,602,76,209,18,81,58,128,16,26,11,74,85,26,13,18,28,65,186
387,Derek Fisher,437,268,10118,927,2466,359,990,568,1476,435,516,79,681,760,976,399,34,403,895,2648
388,Dereon Seabron,5,0,12,2,5,0,0,2,5,0,0,1,0,1,0,0,0,0,1,4
389,Deron Williams,664,603,22166,3703,8550,1042,2937,2661,5613,2338,2797,273,1854,2127,5155,676,156,1872,1639,10786
390,Derrick Brown,220,19,3130,428,818,18,51,410,767,206,333,208,304,512,152,109,42,144,267,1080
391,Derrick Byars,2,0,37,3,11,0,6,3,5,4,4,6,5,11,1,2,0,0,2,10
392,Derrick Caracter,41,0,215,32,66,0,0,32,66,17,23,19,24,43,7,4,10,19,47,81
393,Derrick Favors,868,530,20737,3635,6823,38,192,3597,6631,1579,2398,2104,3916,6020,890,606,1007,1072,2222,8887
394,Derrick Jones Jr.,364,105,6673,821,1629,164,547,657,1082,407,579,440,715,1155,240,217,243,187,682,2213
395,Derrick Rose,693,441,20354,4639,10222,616,1912,4023,8310,2070,2471,483,1644,2127,3426,518,245,1626,813,11964
396,Derrick Walton,71,5,751,50,129,30,78,20,51,24,28,8,50,58,91,28,7,23,57,154
397,Derrick White,420,281,11325,1739,3939,598,1743,1141,2196,960,1130,216,1202,1418,1693,323,337,570,917,5036
398,Derrick Williams,556,138,11488,1643,3790,307,1034,1336,2756,1144,1615,441,1705,2146,377,261,135,503,706,4737
399,Desmond Bane,202,151,5626,1192,2539,511,1201,681,1338,361,409,120,715,835,580,189,67,296,471,3256
400,Desmond Mason,5,4,66,5,12,0,0,5,12,3,4,4,9,13,2,1,1,4,5,13
401,Devean George,45,4,761,89,206,48,123,41,83,16,23,21,93,114,32,41,10,15,89,242
402,Devin Booker,530,505,17907,4453,9665,1089,3055,3364,6610,2693,3102,292,1813,2105,2521,449,146,1637,1568,12688
403,Devin Brown,100,74,2120,272,722,116,328,156,394,138,172,58,190,248,130,66,12,124,144,798
404,Devin Cannady,13,0,219,26,72,21,53,5,19,11,14,1,10,11,11,10,4,7,18,84
405,Devin Ebanks,63,15,711,82,213,8,36,74,177,52,72,51,71,122,24,18,12,35,56,224
406,Devin Harris,782,305,18512,2601,6243,786,2376,1815,3867,2064,2573,162,1458,1620,3037,685,134,1280,1636,8052
407,Devin Robinson,8,0,108,20,35,0,2,20,33,9,14,8,17,25,6,5,6,2,13,49
408,Devin Vassell,171,71,4171,710,1662,292,796,418,866,204,250,76,552,628,328,162,76,137,288,1916
409,Devon Dotson,28,0,188,23,54,4,20,19,34,5,9,9,15,24,30,10,0,8,23,55
410,Devon Hall,11,0,81,6,30,4,17,2,13,4,8,2,5,7,13,4,1,5,6,20
411,Devontae Cacok,36,1,228,41,66,0,0,41,66,9,18,22,57,79,8,13,11,8,24,91
412,Devonte' Graham,386,179,9384,1312,3525,861,2422,451,1103,673,839,149,695,844,1595,294,67,506,493,4158
413,Devyn Marble,44,7,457,35,115,12,54,23,61,15,40,11,58,69,29,22,3,16,39,97
414,Dewan Hernandez,6,0,28,5,14,1,2,4,12,3,5,5,9,14,3,1,0,3,6,14
415,Dewayne Dedmon,628,235,10486,1504,2934,221,703,1283,2231,578,793,916,2564,3480,411,299,491,597,1564,3807
416,Dexter Pittman,61,6,379,53,120,0,0,53,120,18,36,45,56,101,9,8,8,25,91,124
417,Deyonta Davis,107,6,1299,200,334,0,1,200,333,54,85,105,241,346,47,21,61,43,177,454
418,Diamond Stone,7,0,24,3,13,0,0,3,13,4,4,1,5,6,0,0,1,2,5,10
419,Diante Garrett,90,0,1197,117,314,39,111,78,203,15,22,16,96,112,151,51,5,91,80,288
420,Didi Louzada,21,2,314,27,79,20,54,7,25,4,4,11,26,37,13,6,4,13,31,78
421,Dillon Brooks,345,318,9888,1875,4510,573,1675,1302,2835,679,854,253,820,1073,735,325,98,540,1143,5002
422,Dion Waiters,509,234,14250,2522,6155,663,1953,1859,4202,849,1223,209,1115,1324,1346,485,140,890,989,6556
423,Dionte Christmas,31,0,198,22,62,9,31,13,31,18,24,13,25,38,8,2,3,6,19,71
424,Dirk Nowitzki,683,645,20676,4541,9696,902,2354,3639,7342,2492,2792,399,3908,4307,1404,434,424,876,1423,12476
425,Domantas Sabonis,556,415,16678,3350,6078,251,775,3099,5303,1691,2308,1389,4151,5540,2389,433,250,1383,1742,8642
426,Dominic McGuire,270,38,3275,252,608,0,6,252,602,75,126,220,539,759,215,90,99,139,346,579
427,Dominick Barlow,28,0,408,46,86,0,4,46,82,18,25,46,56,102,24,10,19,15,56,110
428,Dominique Jones,80,4,741,83,227,2,21,81,206,78,107,33,81,114,144,29,10,76,64,246
429,Donald Sloan,274,77,4681,555,1374,107,360,448,1014,236,311,75,475,550,794,101,11,293,247,1453
430,Donatas Motiejūnas,251,101,4566,731,1558,121,404,610,1154,249,417,298,654,952,269,118,82,287,538,1832
431,Donovan Mitchell,413,405,14069,3632,8103,1203,3292,2429,4811,1689,2012,332,1390,1722,1843,544,126,1144,1042,10156
432,Donovan Williams,2,0,4,2,5,0,2,2,3,0,0,0,2,2,0,0,0,0,0,4
433,Donta Hall,31,0,445,55,79,0,0,55,79,41,70,52,86,138,19,11,22,18,64,151
434,Donte DiVincenzo,315,128,7650,1006,2449,534,1490,472,959,321,406,323,1105,1428,876,363,67,456,534,2867
435,Donte Grantham,3,0,2,0,2,0,2,0,0,0,0,0,0,0,0,0,0,0,0,0
436,Donté Greene,198,78,3534,508,1205,139,442,369,763,177,260,121,393,514,153,95,102,185,305,1332
437,Dorell Wright,410,167,9652,1321,3177,605,1636,716,1541,527,647,283,1265,1548,682,339,183,358,577,3774
438,Dorian Finney-Smith,526,414,14778,1579,3664,788,2228,791,1436,385,529,808,1616,2424,754,426,240,461,1141,4331
439,Doron Lamb,147,0,1849,183,486,64,164,119,322,69,104,24,117,141,107,37,1,79,158,499
440,Doug McDermott,738,103,15602,2534,5383,1015,2488,1519,2895,639,785,308,1446,1754,724,158,80,496,1093,6722
441,Dragan Bender,203,70,4041,414,1026,198,610,216,416,95,144,129,664,793,265,58,115,223,414,1121
442,Draymond Green,758,608,21809,2430,5418,611,1943,1819,3475,1106,1554,814,4462,5276,4233,1029,771,1718,2151,6577
443,Drew Eubanks,319,96,5214,830,1374,20,67,810,1307,389,530,500,1042,1542,337,127,253,303,549,2069
444,Drew Gooden,350,137,7554,1258,2806,59,213,1199,2593,707,843,767,1371,2138,368,193,201,438,803,3282
445,Drew Gordon,9,0,71,8,19,0,3,8,16,1,2,7,11,18,2,1,0,8,7,17
446,Dru Smith,30,2,316,36,90,10,38,26,52,6,6,4,44,48,44,20,8,6,46,88
447,Duane Washington Jr.,79,10,1362,267,683,121,326,146,357,62,85,6,113,119,148,32,7,91,89,717
448,Duje Dukan,1,0,24,2,10,2,5,0,5,0,0,2,2,4,1,1,0,0,2,6
449,Duncan Robinson,281,210,7323,1034,2413,825,2070,209,343,213,246,51,722,773,409,139,53,243,663,3106
450,Dusty Hannahs,4,0,39,7,21,2,8,5,13,4,4,0,2,2,5,1,0,1,2,20
451,Dwayne Bacon,207,80,4012,571,1419,127,404,444,1015,234,300,58,479,537,230,96,14,124,273,1503
452,Dwayne Jones,2,0,7,0,0,0,0,0,0,0,0,0,2,2,0,0,0,0,1,0
453,Dwight Buycks,49,0,696,115,286,27,73,88,213,53,60,18,58,76,83,30,2,61,53,310
454,Dwight Howard,835,672,24834,4562,7632,21,91,4541,7541,3305,6032,2678,6842,9520,1096,718,1414,2100,2614,12450
455,Dwight Powell,616,243,11414,1679,2816,124,425,1555,2391,1040,1403,965,1748,2713,602,381,274,427,1386,4522
456,Dwyane Wade,727,526,22384,5288,11132,408,1377,4880,9755,3024,4002,821,2439,3260,3304,961,553,1969,1433,14008
457,Dylan Windler,84,0,982,96,231,48,149,48,82,36,45,41,155,196,68,34,15,49,84,276
458,Dyson Daniels,59,11,1042,87,208,27,86,60,122,26,40,36,152,188,134,43,11,57,99,227
459,Dāvis Bertāns,488,40,8678,1193,2851,886,2264,307,587,410,475,150,1065,1215,444,196,167,251,799,3682
460,Džanan Musa,49,0,526,73,194,20,88,53,106,45,62,22,69,91,45,17,1,40,31,211
461,E'Twaun Moore,598,191,12564,1927,4236,556,1432,1371,2804,333,449,282,926,1208,1055,395,131,534,946,4743
462,Earl Barron,91,25,1312,144,411,2,4,142,407,64,103,154,226,380,45,34,30,70,195,354
463,Earl Boykins,132,1,2090,340,791,48,140,292,651,159,186,32,109,141,329,63,6,128,96,887
464,Earl Clark,357,71,4862,618,1544,123,377,495,1167,199,307,254,768,1022,161,108,179,234,435,1558
465,Earl Watson,281,71,5912,443,1122,106,378,337,744,227,326,164,481,645,1112,264,64,462,559,1219
466,Ed Davis,803,134,15387,2033,3610,0,4,2033,3606,848,1444,1742,3334,5076,602,387,651,595,1940,4914
467,Eddie House,192,1,3412,474,1231,226,629,248,602,134,144,35,275,310,232,112,17,123,230,1308
468,Eddy Curry,23,1,170,24,55,0,0,24,55,17,29,10,19,29,1,0,3,26,37,65
469,Edmond Sumner,161,41,2256,356,758,87,255,269,503,198,244,51,193,244,182,91,34,133,242,997
470,Eduardo Nájera,145,10,2012,174,428,57,191,117,237,36,63,93,231,324,90,82,38,70,280,441
471,Edwin Ubiles,4,0,52,5,18,1,5,4,13,3,3,2,8,10,1,1,1,1,1,14
472,Edy Tavares,15,0,129,19,29,0,0,19,29,3,14,15,28,43,5,1,18,9,14,41
473,Ekpe Udoh,445,67,6984,646,1440,0,6,646,1434,401,553,556,798,1354,317,217,531,275,888,1693
474,Elfrid Payton,563,458,15191,2415,5333,220,754,2195,4579,783,1250,587,1694,2281,3261,671,173,1252,1147,5833
475,Elias Harris,2,0,11,0,1,0,0,0,1,0,0,1,0,1,1,1,0,0,0,0
476,Elie Okobo,108,19,1677,186,471,64,203,122,268,87,118,28,160,188,242,56,11,107,163,523
477,Elijah Bryant,1,0,32,6,13,1,5,5,8,3,3,2,4,6,3,0,1,4,4,16
478,Elijah Hughes,90,8,932,104,318,58,213,46,105,17,22,13,112,125,50,29,17,40,79,283
479,Elijah Millsap,69,5,1120,93,284,29,104,64,180,72,106,37,154,191,78,63,19,78,159,287
480,Elliot Williams,122,2,1589,207,495,62,192,145,303,98,149,38,131,169,106,49,6,82,170,574
481,Elton Brand,415,236,10490,1679,3397,0,8,1679,3389,617,841,825,1695,2520,510,348,494,443,1122,3975
482,Emanuel Terry,9,0,64,8,19,0,0,8,19,4,8,14,15,29,6,7,0,9,12,20
483,Emeka Okafor,286,277,7843,1138,2176,0,1,1138,2175,464,819,797,1654,2451,222,163,382,387,696,2740
484,Emmanuel Mudiay,366,179,8432,1426,3577,323,1003,1103,2574,677,907,164,872,1036,1349,256,99,783,572,3852
485,Enes Freedom,890,364,19876,4283,7865,72,238,4211,7627,1789,2299,2757,4395,7152,809,364,418,1339,1962,10427
486,Eric Bledsoe,830,642,23343,4157,9158,979,2905,3178,6253,2368,3015,621,2600,3221,3915,1177,386,2104,1678,11661
487,Eric Dawson,4,0,39,7,12,0,0,7,12,1,2,5,5,10,0,1,2,3,6,15
488,Eric Gordon,809,621,25511,4340,10144,1879,5087,2461,5057,2164,2685,285,1593,1878,2272,649,273,1515,1405,12723
489,Eric Maynor,443,4,6455,732,1872,179,521,553,1351,253,353,106,456,562,1260,182,34,474,483,1896
490,Eric Mika,1,0,19,2,3,0,0,2,3,2,2,2,5,7,0,0,0,0,5,6
491,Eric Moreland,88,3,941,76,143,2,2,74,141,13,33,92,238,330,87,33,57,55,139,167
492,Eric Paschall,158,31,3086,580,1173,95,291,485,882,297,392,140,369,509,214,53,25,164,244,1552
493,Erick Dampier,121,69,2178,186,310,1,4,185,306,85,145,191,411,602,57,30,128,96,244,458
494,Erick Green,61,1,494,71,188,16,57,55,131,14,16,13,30,43,45,14,0,14,34,172
495,Erik McCree,4,0,8,0,2,0,1,0,1,0,0,0,1,1,0,1,0,1,0,0
496,Erik Murphy,24,0,62,3,13,0,3,3,10,0,0,2,6,8,2,0,4,2,7,6
497,Ersan İlyasova,984,561,23736,3925,8848,1158,3175,2767,5673,1542,1997,1716,4045,5761,1157,704,358,999,2386,10550
498,Etan Thomas,36,1,403,41,89,0,0,41,89,25,37,24,63,87,3,5,20,23,50,107
499,Eugene Jeter,62,1,858,106,259,6,30,100,229,37,41,9,61,70,162,29,2,51,54,255
500,Eugene Omoruyi,84,12,1308,204,461,51,180,153,281,104,154,88,141,229,58,56,6,68,184,563
501,Evan Fournier,714,540,20193,3615,8143,1443,3784,2172,4359,1433,1795,282,1666,1948,1855,633,120,1135,1696,10106
502,Evan Mobley,148,148,5046,947,1777,45,194,902,1583,372,556,330,951,1281,398,116,234,279,365,2311
503,Evan Turner,786,351,21395,3182,7352,320,1073,2862,6279,1271,1615,450,3236,3686,2724,599,191,1456,1575,7955
504,Fab Melo,6,0,36,3,6,0,0,3,6,1,4,0,3,3,0,2,2,1,7,7
505,Fabricio Oberto,62,20,695,38,61,0,0,38,61,14,19,37,75,112,51,11,9,39,131,90
506,Facundo Campazzo,138,23,2661,230,624,137,420,93,204,141,171,45,208,253,461,148,37,143,259,738
507,Feron Hunt,2,0,8,0,2,0,0,0,2,0,0,1,0,1,1,1,0,1,1,0
508,Festus Ezeli,170,61,2394,275,536,0,0,275,536,162,291,292,433,725,63,48,166,133,328,712
509,Francisco Elson,91,1,758,65,146,0,0,65,146,30,41,47,97,144,38,24,15,35,98,160
510,Francisco García,317,85,6100,746,1837,355,1010,391,827,151,188,86,533,619,351,225,219,192,564,1998
511,Frank Jackson,214,31,3873,656,1557,247,743,409,814,257,327,82,310,392,222,84,16,169,311,1816
512,Frank Kaminsky,449,49,8395,1337,3097,441,1259,896,1838,604,807,307,1324,1631,683,180,150,323,631,3719
513,Frank Mason III,103,3,1616,247,624,53,176,194,448,148,196,44,160,204,272,55,15,117,124,695
514,Frank Ntilikina,316,65,5411,574,1549,205,635,369,914,177,233,97,460,557,689,210,66,329,598,1530
515,Franz Wagner,159,159,5038,998,2093,226,631,772,1462,460,541,154,531,685,514,145,51,286,347,2682
516,Fred VanVleet,417,268,12398,2053,5108,1000,2684,1053,2424,984,1132,174,1211,1385,2199,562,169,697,882,6090
517,Freddie Gillespie,29,4,511,53,106,0,1,53,105,26,40,55,78,133,14,16,29,17,61,132
518,Furkan Aldemir,41,9,540,40,78,0,5,40,73,13,27,78,98,176,28,17,16,17,96,93
519,Furkan Korkmaz,293,49,5147,748,1841,391,1098,357,743,269,352,81,535,616,366,164,40,204,312,2156
520,Gabe Vincent,195,68,4086,538,1350,288,849,250,501,132,155,59,273,332,450,150,19,225,397,1496
521,Gabe York,5,0,77,10,28,7,24,3,4,5,7,0,8,8,9,4,1,1,9,32
522,Gabriel Deck,17,0,268,40,81,4,19,36,62,18,22,17,29,46,29,9,0,8,11,102
523,Gabriel Lundberg,4,0,44,5,19,3,8,2,11,0,0,2,5,7,11,3,0,3,7,13
524,Gal Mekel,35,1,335,33,106,5,23,28,83,8,12,5,23,28,76,6,1,33,32,79
525,Gani Lawal,1,0,2,0,0,0,0,0,0,0,0,0,0,0,0,0,0,0,1,0
526,Garret Siler,21,0,101,17,31,0,0,17,31,11,22,16,12,28,3,1,4,10,20,45
527,Garrett Temple,842,347,17549,1860,4614,815,2375,1045,2239,685,935,326,1581,1907,1360,681,278,764,1583,5220
528,Garrison Mathews,255,57,4349,451,1156,360,990,91,166,354,415,76,371,447,152,142,42,97,430,1616
529,Gary Clark,251,35,3461,271,769,209,646,62,123,48,57,187,469,656,132,71,91,71,229,799
530,Gary Forbes,111,13,1504,236,544,48,141,188,403,125,178,55,163,218,103,47,10,100,133,645
531,Gary Harris,555,454,15737,2327,5233,847,2303,1480,2930,810,993,326,1013,1339,1102,620,124,622,1001,6311
532,Gary Neal,458,35,9814,1656,3995,578,1547,1078,2448,671,781,105,874,979,756,186,11,494,678,4561
533,Gary Payton II,209,47,3011,425,789,98,283,327,506,63,107,175,403,578,232,199,51,118,350,1011
534,Gary Trent Jr.,328,198,9613,1707,4082,822,2142,885,1940,552,673,136,643,779,473,387,71,239,524,4788
535,George Hill,1041,568,27851,3806,8273,1240,3268,2566,5005,1873,2325,615,2433,3048,3175,923,258,1221,1925,10725
536,George King,5,0,25,0,5,0,4,0,1,1,2,0,6,6,0,0,0,1,4,1
537,Georges Niang,383,19,5966,885,2020,568,1409,317,611,156,179,103,701,804,325,118,46,225,590,2494
538,Georgios Kalaitzakis,26,8,427,62,134,20,52,42,82,28,60,12,30,42,24,22,4,40,38,172
539,Georgios Papagiannis,56,0,599,92,186,0,2,92,184,12,14,50,110,160,38,11,29,40,68,196
540,Gerald Green,477,77,10134,1805,4338,832,2305,973,2033,608,741,213,1059,1272,451,263,162,514,893,5050
541,Gerald Henderson,535,333,13854,2249,5111,249,762,2000,4349,1240,1564,314,1402,1716,1009,358,183,639,930,5987
542,Gerald Wallace,493,402,16435,2114,4631,334,1042,1780,3589,1514,2048,668,2592,3260,1170,682,345,929,1066,6076
543,Gian Clavell,7,0,64,6,18,6,15,0,3,2,2,1,6,7,3,2,0,2,8,20
544,Giannis Antetokounmpo,719,654,23378,5895,10980,494,1721,5401,9259,3996,5645,1256,5635,6891,3379,816,907,2130,2166,16280
545,Gigi Datome,76,2,656,120,275,43,119,77,156,10,12,20,84,104,29,10,15,29,50,293
546,Gilbert Arenas,189,64,4972,817,2148,270,874,547,1274,400,523,63,466,529,796,200,52,483,506,2304
547,Glen Davis,437,148,9950,1579,3533,12,61,1567,3472,739,1056,623,1455,2078,437,331,163,468,1007,3909
548,Glen Rice Jr.,16,1,152,14,52,6,24,8,28,9,13,6,18,24,9,6,1,11,18,43
549,Glenn Robinson III,401,158,7346,1003,2167,275,734,728,1433,323,409,300,785,1085,345,209,75,221,396,2604
550,Goga Bitadze,225,23,2675,422,846,63,253,359,593,179,272,286,421,707,193,72,191,135,394,1086
551,Goran Dragić,1118,620,30117,5409,11734,1344,3749,4065,7985,2480,3263,756,2519,3275,5085,1007,197,2378,2462,14642
552,Gordon Hayward,784,621,24409,4238,9322,1074,2912,3164,6410,2637,3197,591,2926,3517,2782,768,308,1531,1353,12187
553,Gorgui Dieng,729,227,14273,1987,4027,280,774,1707,3253,1059,1335,1179,2849,4028,958,545,624,779,1519,5313
554,Grant Hill*,239,207,6654,974,2077,97,258,877,1819,515,641,186,817,1003,526,176,107,332,476,2560
555,Grant Jerrett,16,0,102,14,52,2,30,12,22,2,2,4,14,18,6,4,4,6,22,32
556,Grant Riller,7,0,27,8,12,2,4,6,8,0,0,0,1,1,3,1,0,1,0,18
557,Grant Williams,288,58,6101,616,1366,293,774,323,592,249,322,258,735,993,341,141,148,250,702,1774
558,Grayson Allen,264,171,6170,857,1969,501,1269,356,700,341,396,123,604,727,448,170,48,229,384,2556
559,Greg Brown III,64,6,733,92,218,20,68,72,150,49,77,40,114,154,38,30,29,42,103,253
560,Greg Monroe,754,433,19385,3713,7188,2,22,3711,7166,1804,2575,2005,3874,5879,1536,746,414,1336,1620,9232
561,Greg Oden,44,27,714,119,201,0,0,119,201,62,87,87,145,232,20,15,61,51,136,300
562,Greg Smith,149,12,1834,243,394,0,1,243,393,110,191,165,324,489,41,32,59,65,290,596
563,Greg Stiemsma,203,42,3048,269,529,0,1,269,528,103,146,190,489,679,97,118,232,143,512,641
564,Greg Whittington,4,0,12,0,3,0,2,0,1,0,0,0,0,0,0,0,0,0,0,0
565,Greivis Vásquez,480,180,11299,1655,3955,521,1469,1134,2486,518,626,145,1049,1194,2258,267,39,881,910,4349
566,Guerschon Yabusele,74,5,486,61,138,21,65,40,73,30,44,40,65,105,31,12,12,27,55,173
567,Gustavo Ayón,190,44,2985,376,697,0,1,376,696,87,183,248,540,788,244,122,90,169,379,839
568,Hakim Warrick,323,46,6011,966,2056,4,41,962,2015,812,1117,415,779,1194,253,114,60,333,461,2748
569,Hamady N'Diaye,33,0,157,7,15,0,0,7,15,6,13,7,18,25,3,2,9,6,33,20
570,Hamed Haddadi,162,0,1258,150,332,0,5,150,327,75,122,164,272,436,47,16,107,114,249,375
571,Hamidou Diallo,315,53,6139,1131,2302,104,359,1027,1943,508,810,326,953,1279,383,264,100,355,713,2874
572,Harrison Barnes,906,845,28951,4605,10198,1308,3438,3297,6760,2543,3133,907,3637,4544,1619,629,165,1114,1411,13061
573,Harry Giles,142,17,1835,356,696,8,31,348,665,112,167,140,403,543,174,61,53,137,323,832
574,Hasheem Thabeet,291,23,2869,210,382,0,0,210,382,151,261,243,469,712,31,69,210,148,549,571
575,Hassan Whiteside,511,332,12645,2687,4583,8,26,2679,4557,1068,1765,1608,3915,5523,327,271,1143,756,1341,6450
576,Hassani Gravett,8,3,171,18,38,11,26,7,12,3,4,1,20,21,20,5,1,9,13,50
577,Haywood Highsmith,78,12,1172,113,272,47,142,66,130,15,35,67,152,219,51,39,20,49,96,288
578,Hedo Türkoğlu,400,269,10291,1268,2972,536,1380,732,1592,472,668,176,1292,1468,1316,289,135,588,980,3544
579,Henry Ellenson,102,2,1046,160,421,66,184,94,237,70,91,33,239,272,65,20,5,50,90,456
580,Henry Sims,181,86,3417,533,1130,4,24,529,1106,311,409,352,555,907,192,104,84,194,405,1381
581,Henry Walker,187,48,3568,470,1039,240,630,230,409,140,180,62,398,460,180,110,28,152,407,1320
582,Herbert Jones,144,135,4286,509,1077,113,336,396,741,260,324,195,370,565,329,233,102,188,446,1391
583,Hilton Armstrong,187,5,1743,139,329,4,10,135,319,69,146,157,314,471,75,70,70,106,297,351
584,Hollis Thompson,305,99,7176,819,1995,395,1036,424,959,222,316,218,723,941,327,186,74,224,610,2255
585,Ian Clark,360,9,4699,737,1690,250,735,487,955,173,213,69,387,456,397,137,47,245,414,1897
586,Ian Mahinmi,612,133,10330,1195,2242,8,50,1187,2192,790,1296,937,1763,2700,356,357,439,599,1631,3188
587,Ignas Brazdeikis,77,1,1087,157,376,50,152,107,224,45,65,47,120,167,75,18,10,43,95,409
588,Ike Anigbogu,14,0,36,4,12,0,0,4,12,5,6,6,6,12,1,1,4,3,1,13
589,Ike Diogu,38,0,484,83,150,0,0,83,150,43,64,41,75,116,2,3,3,23,73,209
590,Iman Shumpert,585,312,14496,1585,4047,651,1919,934,2128,460,608,406,1535,1941,1092,654,160,671,1323,4281
591,Ime Udoka,89,2,1074,96,262,26,99,70,163,46,65,56,154,210,71,42,7,47,97,264
592,Immanuel Quickley,223,27,5389,932,2240,423,1153,509,1087,535,623,114,607,721,681,164,29,257,447,2822
593,Isaac Bonga,143,57,1871,156,361,39,130,117,231,88,116,102,218,320,118,73,37,88,238,439
594,Isaac Humphries,5,1,56,6,21,3,11,3,10,0,0,4,7,11,0,1,0,0,7,15
595,Isaac Okoro,210,174,5806,617,1344,179,542,438,802,311,415,192,402,594,336,174,76,186,507,1724
596,Isaiah Briscoe,39,0,559,55,138,11,34,44,104,15,26,5,69,74,87,11,2,31,66,136
597,Isaiah Canaan,332,115,6788,878,2340,513,1450,365,890,429,512,93,535,628,712,204,29,385,535,2698
598,Isaiah Hartenstein,293,14,4447,656,1143,28,90,628,1053,261,387,506,861,1367,405,157,243,267,685,1601
599,Isaiah Hicks,21,0,272,37,80,2,9,35,71,16,23,12,36,48,18,3,7,17,50,92
600,Isaiah Jackson,99,27,1583,295,524,7,30,288,494,155,234,173,258,431,61,56,145,91,246,752
601,Isaiah Joe,169,12,2387,334,818,245,635,89,183,129,155,39,228,267,143,74,15,69,186,1042
602,Isaiah Livers,71,27,1582,161,378,101,267,60,111,44,53,43,157,200,62,41,35,45,140,467
603,Isaiah Mobley,12,0,84,12,28,3,8,9,20,4,4,4,16,20,3,4,3,1,8,31
604,Isaiah Roby,151,64,2858,440,908,94,268,346,640,185,274,185,482,667,216,106,78,188,325,1159
605,Isaiah Stewart,189,132,4685,671,1340,103,314,568,1026,248,344,500,973,1473,211,81,198,220,528,1693
606,Isaiah Taylor,71,9,1219,164,397,20,82,144,315,100,143,23,74,97,209,35,11,84,122,448
607,Isaiah Thomas,671,379,18484,3726,8676,1254,3493,2472,5183,2780,3187,338,1232,1570,3109,551,74,1495,1388,11486
608,Isaiah Todd,18,1,135,10,45,5,26,5,19,4,8,5,19,24,8,5,2,6,8,29
609,Isaiah Whitehead,89,26,1823,244,594,51,167,193,427,104,132,36,174,210,212,50,38,166,198,643
610,Ish Smith,1080,242,20142,3241,7675,416,1280,2825,6395,691,1032,377,2155,2532,4032,751,259,1356,1321,7589
611,Ish Wainright,105,2,1274,125,331,76,232,49,99,33,43,72,121,193,68,58,28,35,166,359
612,Ivan Johnson,125,5,1969,326,631,3,19,323,612,153,231,141,351,492,78,99,32,140,247,808
613,Ivan Rabb,85,18,1237,202,364,3,15,199,349,78,105,123,241,364,86,29,27,70,145,485
614,Ivica Zubac,495,340,10056,1740,2906,1,12,1739,2894,863,1154,1155,2313,3468,550,155,453,569,1164,4344
615,J.J. Barea,675,82,14036,2487,5880,737,2101,1750,3779,818,1022,206,1293,1499,2919,279,17,1110,980,6529
616,J.J. Hickson,561,335,12900,2212,4409,0,24,2212,4385,1070,1763,1293,2648,3941,508,305,328,824,1084,5494
617,J.J. O'Brien,2,0,6,0,1,0,0,0,1,0,0,0,1,1,0,1,0,0,1,0
618,J.J. Redick,922,496,25057,4252,9521,2059,5013,2193,4508,2118,2365,174,1780,1954,2084,432,99,1124,1431,12681
619,J.P. Macura,3,0,18,3,9,0,4,3,5,0,0,0,3,3,2,0,0,0,0,6
620,J.R. Giddens,64,2,478,56,120,0,20,56,100,26,46,32,70,102,26,18,4,34,58,138
621,J.R. Smith,698,323,20370,3237,7838,1474,3958,1763,3880,883,1224,350,2087,2437,1626,775,176,902,1648,8831
622,JD Davison,12,0,66,8,19,2,7,6,12,1,2,2,7,9,11,2,2,4,5,19
623,JT Thor,102,8,1231,119,293,46,150,73,143,45,67,47,148,195,55,30,34,54,92,329
624,Ja Morant,248,246,7964,2023,4285,313,976,1710,3309,1198,1592,248,945,1193,1830,247,69,825,383,5557
625,JaJuan Johnson,36,0,298,54,121,0,0,54,121,6,9,20,38,58,6,5,14,14,25,114
626,JaKarr Sampson,309,134,4709,623,1343,74,305,549,1038,287,431,200,618,818,207,114,143,258,591,1607
627,JaMychal Green,633,173,12468,1836,3834,501,1352,1335,2482,708,902,1014,2426,3440,550,348,265,671,1607,4881
628,JaQuori McLaughlin,4,0,11,0,2,0,1,0,1,0,0,0,0,0,2,0,0,0,1,0
629,JaVale McGee,918,376,15663,3178,5504,19,95,3159,5409,992,1687,1720,3214,4934,419,354,1369,966,2039,7367
630,Jabari Bird,13,1,115,15,26,3,7,12,19,6,13,6,13,19,8,3,1,8,7,39
631,Jabari Brown,19,5,568,70,170,23,62,47,108,64,85,3,33,36,40,12,2,32,33,227
632,Jabari Parker,425,230,11341,2385,4812,307,976,2078,3836,836,1131,599,1781,2380,841,363,169,759,884,5913
633,Jabari Smith Jr.,79,79,2451,364,892,120,391,244,501,162,206,122,447,569,101,43,74,104,227,1010
634,Jabari Walker,56,0,619,83,198,16,56,67,142,34,45,48,83,131,34,10,13,29,69,216
635,Jack Cooley,23,0,174,22,49,0,0,22,49,23,40,24,31,55,7,7,3,6,36,67
636,Jack White,17,0,66,8,19,3,9,5,10,2,3,6,11,17,4,3,2,2,9,21
637,Jacob Evans,88,3,1040,108,321,30,93,78,228,50,59,24,83,107,85,27,27,61,110,296
638,Jacob Gilyard,1,0,41,1,3,1,3,0,0,0,0,0,4,4,7,3,0,2,3,3
639,Jacob Pullen,3,0,6,1,2,0,1,1,1,0,0,0,0,0,0,0,0,1,0,2
640,Jacob Wiley,5,0,33,1,4,1,2,0,2,1,2,2,9,11,2,1,0,0,4,4
641,Jaden Hardy,48,5,708,146,333,63,156,83,177,65,79,11,78,89,65,17,7,46,64,420
642,Jaden Ivey,74,73,2304,409,983,120,350,289,633,266,356,73,215,288,387,61,17,237,242,1204
643,Jaden McDaniels,212,137,5730,789,1637,259,719,530,918,190,260,220,612,832,298,161,190,234,668,2027
644,Jaden Springer,18,2,95,18,36,2,5,16,31,6,8,7,9,16,8,7,5,4,15,44
645,Jae Crowder,980,526,24514,3195,7681,1476,4308,1719,3373,1399,1792,704,3458,4162,1563,956,330,839,2016,9265
646,Jae'Sean Tate,179,142,4776,789,1583,136,443,653,1140,282,400,308,604,912,484,178,84,284,614,1996
647,Jahlil Okafor,275,116,5180,1169,2154,7,31,1162,2123,397,585,398,856,1254,237,76,213,368,566,2742
648,Jahmi'us Ramsey,32,0,228,39,96,10,37,29,59,12,19,6,17,23,13,5,2,8,18,100
649,Jaime Echenique,1,0,3,0,0,0,0,0,0,0,0,0,0,0,0,0,0,0,0,0
650,Jake LaRavia,35,0,414,37,95,24,71,13,24,7,9,19,44,63,21,12,4,18,49,105
651,Jake Layman,243,49,3099,458,996,131,437,327,559,128,178,102,315,417,127,99,71,122,254,1175
652,Jakob Poeltl,560,306,12221,2126,3384,2,5,2124,3379,575,1052,1505,2325,3830,995,346,696,658,1349,4829
653,Jalen Brunson,345,195,9213,1866,3783,415,1075,1451,2708,772,951,157,927,1084,1455,221,27,500,613,4919
654,Jalen Duren,67,31,1670,258,398,0,2,258,396,96,157,229,366,595,75,44,59,92,182,612
655,Jalen Green,143,143,4740,972,2313,344,1012,628,1301,552,699,76,434,510,457,103,36,335,234,2840
656,Jalen Harris,13,2,172,36,72,17,36,19,36,7,9,3,15,18,17,8,0,14,15,96
657,Jalen Johnson,92,6,1162,180,363,33,117,147,246,54,85,53,255,308,86,41,36,50,122,447
658,Jalen Jones,48,0,576,78,198,30,80,48,118,43,65,37,73,110,15,19,4,22,71,229
659,Jalen Lecque,9,0,44,5,19,0,5,5,14,5,5,2,5,7,4,0,0,2,3,15
660,Jalen McDaniels,278,68,5918,851,1842,239,701,612,1141,344,429,223,873,1096,384,228,112,278,642,2285
661,Jalen Smith,197,48,3284,616,1258,138,452,478,806,265,348,338,707,1045,118,52,147,163,361,1635
662,Jalen Suggs,101,64,2553,384,992,108,398,276,594,212,282,81,251,332,364,126,46,237,262,1088
663,Jalen Williams,75,62,2276,414,794,73,205,341,589,155,191,84,253,337,248,103,35,123,191,1056
664,Jamaal Franklin,24,0,174,17,41,6,13,11,28,2,2,5,20,25,9,4,3,14,27,42
665,Jamaal Magloire,88,1,891,58,123,0,0,58,123,37,104,83,212,295,10,17,23,44,151,153
666,Jamaal Tinsley,149,39,2427,199,535,57,218,142,317,53,70,36,201,237,544,116,27,230,230,508
667,Jamal Cain,18,0,240,37,66,7,20,30,46,17,22,15,37,52,12,11,1,6,21,98
668,Jamal Crawford,730,40,19550,3567,8575,1196,3426,2371,5149,2019,2300,212,1105,1317,2058,556,126,1207,1000,10349
669,Jamal Murray,410,336,12517,2546,5692,845,2266,1701,3426,1000,1150,318,1197,1515,1722,394,125,823,750,6937
670,Jamaree Bouyea,10,0,142,12,28,4,12,8,16,2,4,2,10,12,8,8,4,8,12,30
671,Jamario Moon,187,42,3259,323,767,110,356,213,411,68,81,74,469,543,158,91,101,75,204,824
672,Jameel Warney,3,0,27,7,12,0,0,7,12,3,5,4,5,9,0,0,0,1,2,17
673,Jameer Nelson,662,433,17962,2531,6084,958,2681,1573,3403,639,790,283,1565,1848,3462,511,54,1334,1524,6659
674,Jamel Artis,15,1,279,31,79,8,29,23,50,7,12,4,34,38,18,2,3,8,11,77
675,James Anderson,286,85,4721,577,1402,217,671,360,731,200,261,126,506,632,333,136,60,241,317,1571
676,James Bouknight,65,0,819,118,334,50,158,68,176,47,61,30,94,124,67,21,6,47,78,333
677,James Ennis III,623,212,12506,1452,3159,507,1424,945,1735,761,959,623,1388,2011,572,385,183,472,1246,4172
678,James Harden,1109,894,38781,8040,18219,3023,8376,5017,9843,8105,9415,872,5624,6496,8157,1655,612,4195,2820,27208
679,James Johnson,886,281,17961,2661,5639,453,1511,2208,4128,948,1412,698,2445,3143,1859,676,763,1206,2030,6723
680,James Jones,379,34,4688,474,1179,385,943,89,236,190,237,55,393,448,153,92,70,85,395,1523
681,James Michael McAdoo,111,3,874,133,252,5,17,128,235,63,118,79,109,188,37,33,47,42,108,334
682,James Nunnally,65,0,582,59,173,36,112,23,61,21,28,4,53,57,33,14,4,18,43,175
683,James Posey,126,2,2570,207,586,148,454,59,132,77,95,42,434,476,151,66,25,75,307,639
684,James Singleton,126,6,2216,235,583,16,83,219,500,120,139,241,392,633,77,65,94,108,253,606
685,James Southerland,8,0,60,10,30,6,12,4,18,2,4,0,16,16,0,2,4,2,6,28
686,James Webb III,10,0,120,6,24,4,19,2,5,0,0,8,16,24,4,1,0,4,10,16
687,James White,57,16,435,50,116,14,41,36,75,11,19,5,43,48,29,13,4,17,44,125
688,James Wiseman,129,71,2570,569,1046,20,78,549,968,190,280,201,559,760,86,25,90,162,337,1348
689,James Young,95,0,812,77,210,38,137,39,73,27,48,19,77,96,28,24,5,15,58,219
690,JamesOn Curry,1,0,0,0,0,0,0,0,0,0,0,0,0,0,0,0,0,0,0,0
691,Jamil Wilson,15,10,274,38,81,27,63,11,18,2,4,3,29,32,10,5,8,8,34,105
692,Jamorko Pickett,13,0,176,18,50,13,39,5,11,1,2,6,26,32,7,0,7,5,12,50
693,Jan Veselý,216,26,3231,352,678,0,2,352,676,83,213,306,447,753,117,160,119,159,505,787
694,Jannero Pargo,215,5,2829,460,1211,202,590,258,621,95,104,39,205,244,379,99,11,210,241,1217
695,Jared Butler,48,2,437,76,183,35,102,41,81,11,16,6,43,49,71,22,8,38,52,198
696,Jared Cunningham,141,6,1095,102,299,32,108,70,191,107,157,10,90,100,67,38,4,55,129,343
697,Jared Dudley,763,265,17578,2109,4564,845,2132,1264,2432,776,1053,602,1756,2358,1257,598,149,670,1403,5839
698,Jared Harper,16,0,67,15,34,5,15,10,19,7,8,2,2,4,15,4,1,5,6,42
699,Jared Jeffries,301,96,5869,411,998,49,178,362,820,235,393,479,541,1020,314,221,207,240,703,1106
700,Jared Rhoden,14,0,198,17,44,5,20,12,24,6,6,11,26,37,4,4,1,3,23,45
701,Jared Sullinger,269,172,6532,1172,2685,141,518,1031,2167,408,564,684,1322,2006,477,180,161,332,784,2893
702,Jared Terrell,14,0,111,12,39,4,17,8,22,3,6,1,5,6,12,3,2,10,16,31
703,Jarell Eddie,37,0,227,26,88,19,67,7,21,16,17,3,29,32,5,8,1,2,6,87
704,Jarell Martin,184,40,2927,376,867,63,182,313,685,183,239,189,450,639,114,67,73,144,411,998
705,Jaren Jackson Jr.,267,258,7308,1550,3325,441,1253,1109,2072,850,1076,372,1104,1476,300,242,558,449,993,4391
706,Jarnell Stokes,35,2,169,28,48,0,0,28,48,18,34,19,25,44,8,8,5,7,30,74
707,Jaron Blossomgame,27,4,439,47,106,10,39,37,67,10,13,26,72,98,13,7,8,11,20,114
708,Jarred Vanderbilt,333,227,6938,868,1534,61,202,807,1332,345,525,686,1511,2197,545,341,137,342,704,2142
709,Jarrell Brantley,41,0,273,43,94,19,50,24,44,5,6,12,41,53,29,10,9,17,27,110
710,Jarrett Allen,472,389,13147,2239,3565,25,124,2214,3441,1217,1729,1356,2905,4261,686,273,639,649,935,5720
711,Jarrett Culver,144,43,2480,367,915,92,333,275,582,108,212,127,275,402,173,100,54,136,239,934
712,Jarrett Jack,628,262,16667,2472,5704,427,1250,2045,4454,1353,1580,186,1596,1782,2907,461,84,1182,1037,6724
713,Jarrod Uthoff,23,0,221,30,74,9,27,21,47,9,11,12,22,34,9,4,4,3,12,78
714,Jarron Collins,90,10,623,24,73,0,0,24,73,24,45,50,60,110,10,10,5,24,100,72
715,Jarron Cumberland,3,0,12,1,2,0,1,1,1,0,0,1,2,3,1,0,0,0,2,2
716,Jarvis Hayes,45,19,1033,138,328,60,179,78,149,14,18,9,99,108,40,29,9,28,91,350
717,Jarvis Varnado,74,0,794,78,134,0,0,78,134,58,112,42,102,144,32,22,62,32,144,214
718,Jason Collins,201,57,1956,87,216,1,5,86,211,83,126,98,205,303,56,48,35,84,352,258
719,Jason Hart,10,0,44,2,4,0,0,2,4,0,0,0,4,4,12,4,2,6,8,4
720,Jason Kapono,108,14,1357,154,384,72,206,82,178,14,21,19,72,91,54,26,7,42,105,394
721,Jason Kidd*,284,256,8956,750,1949,502,1353,248,596,209,252,148,1169,1317,1892,486,99,541,469,2211
722,Jason Maxiell,365,169,7101,820,1741,0,3,820,1738,344,607,602,1003,1605,179,150,268,307,733,1984
723,Jason Preston,14,0,124,18,41,5,18,13,23,0,2,2,20,22,27,2,0,10,7,41
724,Jason Richardson,345,338,10858,1857,4220,725,1898,1132,2322,446,626,283,1170,1453,633,358,99,384,669,4885
725,Jason Smith,560,104,9112,1452,3109,89,264,1363,2845,509,635,595,1302,1897,447,189,365,472,1225,3502
726,Jason Terry,610,76,14876,2144,4981,895,2393,1249,2588,734,858,131,861,992,1513,540,113,716,863,5917
727,Jason Thompson,553,363,12987,1808,3646,11,49,1797,3597,820,1260,1062,2346,3408,571,249,375,616,1517,4447
728,Jason Williams,136,18,2293,233,560,104,297,129,263,31,41,13,173,186,402,75,5,123,81,601
729,Javin DeLaurier,1,0,3,0,0,0,0,0,0,0,0,0,1,1,0,1,0,0,1,0
730,Javonte Green,227,52,3413,406,763,78,229,328,534,198,263,194,405,599,143,171,73,111,317,1088
731,Javonte Smart,34,2,400,38,120,16,54,22,66,10,12,10,38,48,32,12,6,22,24,102
732,Jawad Williams,80,7,1133,122,332,43,138,79,194,41,57,23,108,131,56,21,8,34,107,328
733,Jawun Evans,64,4,908,95,281,15,60,80,221,38,49,11,97,108,120,42,6,56,113,243
734,Jaxson Hayes,241,47,4052,680,1093,30,104,650,989,418,581,343,620,963,168,104,167,177,484,1808
735,Jay Huff,11,0,115,15,28,6,14,9,14,15,16,7,18,25,11,4,5,6,16,51
736,Jay Scrubb,24,1,235,37,89,10,32,27,57,13,17,4,32,36,10,10,3,17,16,97
737,Jaylen Adams,41,1,446,39,118,25,76,14,42,7,9,11,52,63,67,14,5,28,46,110
738,Jaylen Brown,470,363,13964,3153,6616,883,2417,2270,4199,1239,1714,440,2013,2453,1054,456,172,949,1179,8428
739,Jaylen Hoard,39,5,663,103,210,9,39,94,171,42,68,65,116,181,45,24,10,29,45,257
740,Jaylen Morris,13,0,143,17,48,3,15,14,33,3,6,2,21,23,13,4,1,8,5,40
741,Jaylen Nowell,184,3,3137,637,1426,183,568,454,858,210,263,80,321,401,343,94,28,132,257,1667
742,Jaylin Williams,49,36,914,102,234,46,113,56,121,38,54,44,197,241,76,28,12,37,111,288
743,Jaysean Paige,1,0,7,0,3,0,2,0,1,0,0,0,1,1,1,0,0,1,2,0
744,Jayson Tatum,439,439,14916,3455,7538,1067,2844,2388,4694,1888,2230,397,2672,3069,1448,488,303,992,930,9865
745,Jeenathan Williams,5,4,127,24,39,3,8,21,31,2,3,10,5,15,10,3,2,4,13,53
746,Jeff Adrien,206,29,3109,407,832,0,2,407,830,257,407,323,642,965,138,74,115,130,367,1071
747,Jeff Ayres,237,15,2322,287,519,2,5,285,514,114,147,196,436,632,99,37,66,132,360,690
748,Jeff Dowtin,43,0,475,41,109,7,34,34,75,10,13,22,37,59,51,19,5,15,23,99
749,Jeff Foote,4,0,39,2,6,0,0,2,6,0,0,1,5,6,0,0,1,2,5,4
750,Jeff Foster,83,6,1336,111,231,1,5,110,226,38,66,212,261,473,71,35,36,47,198,261
751,Jeff Green,1230,686,34522,5476,12207,1292,3893,4184,8314,2918,3612,960,3941,4901,1850,800,604,1538,2580,15162
752,Jeff Taylor,132,50,2566,299,731,82,257,217,474,127,191,80,183,263,107,72,21,92,234,807
753,Jeff Teague,940,624,24578,3884,8757,787,2167,3097,6590,2518,2975,316,1903,2219,5025,1014,308,1983,1704,11073
754,Jeff Withey,206,15,2072,249,474,2,14,247,460,166,232,181,337,518,64,56,156,76,229,666
755,Jemerrio Jones,8,2,158,14,36,2,10,12,26,1,2,18,34,52,13,8,5,5,12,31
756,Jerami Grant,698,337,18231,2767,6064,765,2131,2002,3933,1757,2410,580,2097,2677,943,432,747,777,1564,8056
757,Jerel McNeal,6,0,36,3,11,1,2,2,9,2,2,0,3,3,2,3,1,5,5,9
758,Jeremiah Martin,18,0,174,33,86,8,30,25,56,12,19,3,14,17,22,12,4,10,8,86
759,Jeremiah Robinson-Earl,92,56,1901,244,572,95,276,149,296,75,96,146,308,454,92,53,26,58,146,658
760,Jeremy Evans,250,9,2626,364,640,6,26,358,614,145,211,239,402,641,107,90,121,85,291,879
761,Jeremy Lamb,629,136,12831,2260,5188,656,1925,1604,3263,1039,1215,329,1898,2227,985,448,240,503,983,6215
762,Jeremy Lin,554,225,13654,2123,4890,504,1500,1619,3390,1524,1876,219,1298,1517,2273,566,188,1209,1204,6274
763,Jeremy Pargo,125,27,1778,259,672,63,193,196,479,100,152,29,109,138,247,42,4,150,146,681
764,Jeremy Sochan,56,53,1458,250,552,33,134,217,418,81,116,95,200,295,142,43,23,97,138,614
765,Jeremy Tyler,125,23,1102,166,373,0,1,166,372,63,112,104,185,289,26,24,44,74,174,395
766,Jerian Grant,279,61,4998,593,1442,174,539,419,903,332,431,92,438,530,805,205,33,274,411,1692
767,Jericho Sims,93,21,1367,122,161,0,1,122,160,24,45,160,251,411,46,26,50,47,162,268
768,Jermaine O'Neal,218,121,4904,800,1593,0,3,800,1590,407,546,353,891,1244,181,68,286,298,585,2007
769,Jermaine Taylor,99,20,1269,233,511,33,112,200,399,75,102,73,97,170,80,38,13,111,93,574
770,Jerome Dyson,9,1,180,19,48,1,8,18,40,28,36,2,17,19,18,11,2,20,19,67
771,Jerome Jordan,65,0,491,67,127,0,0,67,127,46,54,66,66,132,17,9,21,24,73,180
772,Jerome Robinson,176,18,2583,302,825,127,405,175,420,102,143,33,304,337,218,79,43,130,301,833
773,Jerrelle Benimon,2,0,3,0,0,0,0,0,0,0,0,1,2,3,0,0,0,1,0,0
774,Jerry Smith,5,0,46,3,14,1,6,2,8,0,0,2,5,7,4,5,0,0,5,7
775,Jerry Stackhouse,116,1,1722,235,600,89,261,146,339,101,122,31,132,163,122,38,18,105,102,660
776,Jerryd Bayless,676,132,15013,2116,5125,617,1713,1499,3412,1149,1409,216,1272,1488,2056,452,85,978,1435,5998
777,Jevon Carter,370,51,5859,686,1722,426,1076,260,646,114,140,123,575,698,613,216,94,227,489,1912
778,Jimmer Fredette,296,7,3750,633,1514,234,605,399,909,220,250,61,234,295,396,109,14,273,259,1720
779,Jimmy Butler,819,714,27187,4868,10423,659,2028,4209,8395,4508,5347,1332,3043,4375,3439,1367,383,1318,1187,14903
780,Joakim Noah,518,426,15174,1864,3835,0,14,1864,3821,1128,1603,1723,3313,5036,1717,417,700,962,1463,4856
781,Jock Landale,123,5,1568,279,541,50,173,229,368,113,146,182,236,418,113,26,44,90,179,721
782,Jodie Meeks,599,204,12829,1769,4237,817,2210,952,2027,914,1043,157,1062,1219,622,431,41,435,684,5269
783,Joe Alexander,8,0,29,1,6,0,1,1,5,2,3,2,3,5,2,1,1,0,9,4
784,Joe Chealey,5,0,41,1,10,0,4,1,6,2,2,0,0,0,2,4,0,2,3,4
785,Joe Harris,488,283,12128,1877,3910,1016,2324,861,1586,376,487,261,1247,1508,780,238,93,518,990,5146
786,Joe Ingles,636,313,16202,1913,4264,1154,2825,759,1439,431,559,202,1840,2042,2363,577,96,982,1173,5411
787,Joe Johnson,790,623,25236,4245,9638,1200,3282,3045,6356,1384,1681,499,2409,2908,2646,526,103,1272,1218,11074
788,Joe Smith,96,7,730,83,225,1,7,82,218,43,52,72,127,199,29,6,27,32,121,210
789,Joe Wieskamp,38,0,255,23,70,17,55,6,15,7,13,4,14,18,12,4,3,3,17,70
790,Joe Young,127,1,1077,168,427,40,135,128,292,53,69,19,111,130,119,33,1,64,74,429
791,Joel Anthony,434,81,5696,325,630,0,0,325,630,213,318,450,651,1101,71,101,419,172,642,863
792,Joel Ayayi,7,0,20,1,6,0,1,1,5,0,0,1,2,3,4,0,0,0,0,2
793,Joel Bolomboy,18,0,91,12,22,1,5,11,17,6,12,10,17,27,2,3,2,4,4,31
794,Joel Embiid,394,394,12524,3527,7046,455,1352,3072,5694,3209,3917,877,3525,4402,1354,351,654,1335,1215,10718
795,Joel Freeland,151,9,1821,209,455,0,2,209,453,59,81,190,328,518,65,32,56,74,255,477
796,Joel Przybilla,141,47,2236,118,226,0,0,118,226,72,125,180,507,687,44,23,91,123,329,308
797,Joey Dorsey,142,26,1588,150,284,0,1,150,283,65,172,214,341,555,56,70,46,92,277,365
798,Joey Graham,102,26,1345,187,381,11,43,176,338,83,109,47,160,207,40,29,14,71,177,468
799,Joffrey Lauvergne,278,19,3803,625,1331,82,270,543,1061,202,290,311,729,1040,250,80,40,221,369,1534
800,Johan Petro,203,35,2601,340,761,2,10,338,751,71,98,195,482,677,119,75,79,131,428,753
801,John Butler,19,1,221,17,53,8,35,9,18,3,4,3,14,17,11,7,9,1,22,45
802,John Collins,364,313,10618,2259,4103,347,976,1912,3127,903,1153,799,2104,2903,540,209,377,523,1129,5768
803,John Henson,485,168,9352,1533,2832,28,116,1505,2716,510,903,848,1682,2530,550,235,684,532,1076,3604
804,John Holland,25,0,175,17,59,11,36,6,23,9,13,6,18,24,5,7,2,8,10,54
805,John Jenkins,240,11,2996,424,970,155,428,269,542,151,179,50,294,344,195,39,17,131,127,1154
806,John Konchar,206,30,3542,366,757,138,369,228,388,81,117,204,610,814,278,159,59,91,249,951
807,John Lucas III,182,8,2437,378,993,146,406,232,587,61,80,46,150,196,317,66,2,106,151,963
808,John Salmons,534,302,15452,1948,4711,585,1568,1363,3143,897,1113,194,1300,1494,1324,461,154,626,982,5378
809,John Wall,647,604,22588,4373,10171,651,2021,3722,8150,2691,3468,361,2343,2704,5735,1045,439,2412,1394,12088
810,Johnathan Motley,46,4,373,90,163,2,10,88,153,44,75,35,75,110,26,11,5,30,51,226
811,Johnathan Williams,39,6,552,84,144,0,4,84,140,34,61,72,91,163,21,9,15,21,78,202
812,Johnny Davis,28,5,423,66,171,17,70,49,101,14,27,10,55,65,28,10,8,17,48,163
813,Johnny Juzang,18,0,232,35,104,15,63,20,41,2,4,8,31,39,8,4,3,3,13,87
814,Johnny O'Bryant,158,19,1764,228,560,21,56,207,504,70,104,138,233,371,75,32,20,83,209,547
815,Jon Brockman,150,10,1570,118,242,0,1,118,241,84,136,212,260,472,49,33,9,57,267,320
816,Jon Leuer,405,80,6132,1004,2075,125,384,879,1691,318,420,370,1093,1463,309,143,102,267,604,2451
817,Jon Teske,3,0,8,0,1,0,0,0,1,0,2,0,2,2,1,1,0,0,1,0
818,Jonah Bolden,58,10,733,88,184,34,104,54,80,17,35,53,130,183,40,23,43,40,119,227
819,Jonas Jerebko,710,119,12553,1634,3582,454,1241,1180,2341,645,831,856,1948,2804,596,367,171,482,1360,4367
820,Jonas Valančiūnas,823,772,21200,4450,7931,207,589,4243,7342,2090,2648,2284,5510,7794,1034,329,807,1390,2373,11197
821,Jonathan Bender,25,1,292,40,100,14,39,26,61,24,26,15,37,52,16,2,17,28,33,118
822,Jonathan Gibson,21,0,271,49,118,21,57,28,61,21,29,1,24,25,30,8,0,24,26,140
823,Jonathan Isaac,147,106,3636,495,1141,140,421,355,720,194,246,188,597,785,152,159,210,155,279,1324
824,Jonathan Kuminga,137,28,2579,497,957,104,295,393,662,220,328,124,341,465,189,72,53,169,303,1318
825,Jonathon Simmons,314,78,6362,919,2124,173,561,746,1563,497,659,151,596,747,611,187,76,411,602,2508
826,Jonny Flynn,192,91,4154,597,1510,128,383,469,1127,313,390,52,294,346,730,128,9,418,202,1635
827,Jontay Porter,11,0,54,8,15,3,8,5,7,3,5,4,10,14,1,3,1,7,12,22
828,Jordan Adams,32,0,263,37,92,10,26,27,66,17,28,9,21,30,19,19,7,16,26,101
829,Jordan Bell,196,18,2275,299,555,8,34,291,521,95,151,190,412,602,224,68,137,143,226,701
830,Jordan Bone,24,0,249,28,74,12,42,16,32,0,0,4,24,28,26,3,0,5,17,68
831,Jordan Clarkson,813,207,21772,4777,10806,1491,4359,3286,6447,1644,1995,680,1941,2621,2153,652,123,1408,1348,12689
832,Jordan Crawford,474,166,11438,2106,5143,536,1700,1570,3443,878,1054,256,944,1200,1506,321,38,887,726,5626
833,Jordan Farmar,285,38,5868,884,2115,375,969,509,1146,260,328,78,461,539,936,213,34,427,426,2403
834,Jordan Goodwin,64,7,1112,158,356,38,119,120,237,53,69,57,149,206,168,58,26,57,96,407
835,Jordan Hall,9,0,83,9,28,3,15,6,13,7,9,3,9,12,11,1,0,7,6,28
836,Jordan Hamilton,211,33,3119,489,1215,207,582,282,633,109,154,121,502,623,179,117,54,148,211,1294
837,Jordan Hill,495,128,8867,1538,3099,3,27,1535,3072,591,852,1016,1734,2750,358,178,320,487,1038,3670
838,Jordan Loyd,12,0,55,8,18,4,8,4,10,9,11,1,8,9,6,0,0,2,5,29
839,Jordan McLaughlin,186,7,3108,336,765,113,331,223,434,94,127,65,248,313,646,174,24,153,157,879
840,Jordan McRae,182,14,2675,485,1168,138,382,347,786,263,343,56,313,369,285,69,47,145,237,1371
841,Jordan Mickey,64,4,482,62,138,2,17,60,121,26,43,37,91,128,17,9,27,28,53,152
842,Jordan Nwora,216,43,3835,636,1487,279,711,357,776,191,240,148,591,739,242,89,52,213,248,1742
843,Jordan Poole,266,115,7003,1396,3312,596,1758,800,1554,807,919,90,605,695,906,184,63,564,600,4195
844,Jordan Schakel,6,0,36,2,13,2,7,0,6,2,2,2,6,8,1,2,0,1,1,8
845,Jordan Sibert,1,0,4,1,1,1,1,0,0,0,0,0,0,0,0,0,0,0,0,3
846,Jordan Williams,43,5,635,77,152,0,0,77,152,43,66,66,90,156,11,21,15,23,61,197
847,Jorge Gutiérrez,67,4,657,75,147,3,20,72,127,37,49,13,66,79,91,25,1,44,90,190
848,Jose Alvarado,115,11,2144,332,783,115,357,217,426,101,133,53,188,241,338,138,17,121,198,880
849,Josh Akognon,3,0,9,2,4,1,2,1,2,0,0,0,1,1,1,0,0,0,3,5
850,Josh Boone,63,28,1045,117,223,0,0,117,223,19,58,124,191,315,29,30,48,37,111,253
851,Josh Childress,106,3,1509,175,334,6,43,169,291,30,63,106,162,268,83,50,31,54,110,386
852,Josh Christopher,138,4,2120,377,829,77,278,300,551,128,173,72,185,257,223,98,28,174,156,959
853,Josh Davis,15,0,130,10,27,4,13,6,14,4,8,16,11,27,6,7,1,3,19,28
854,Josh Giddey,130,130,4067,820,1788,132,447,688,1341,162,224,246,774,1020,814,108,51,382,231,1934
855,Josh Gray,7,0,109,12,43,3,13,9,30,7,11,3,9,12,14,8,2,12,9,34
856,Josh Green,166,29,3023,377,731,100,272,277,459,112,162,135,286,421,210,103,22,133,306,966
857,Josh Hall,21,1,336,30,99,4,37,26,62,22,44,6,53,59,28,4,1,25,37,86
858,Josh Harrellson,75,4,888,105,240,33,95,72,145,22,35,80,147,227,26,30,36,33,96,265
859,Josh Hart,502,275,14770,1865,3893,622,1772,1243,2121,859,1152,599,2676,3275,1418,510,159,691,1215,5211
860,Josh Howard,142,56,3443,547,1376,67,254,480,1122,329,434,126,392,518,174,107,40,175,325,1490
861,Josh Huestis,76,10,1068,71,205,39,125,32,80,6,25,48,132,180,23,16,48,29,85,187
862,Josh Jackson,342,95,7548,1342,3239,296,1031,1046,2208,624,914,271,1029,1300,588,277,191,583,821,3604
863,Josh Magette,26,0,254,20,61,9,26,11,35,9,10,3,22,25,62,11,2,14,20,58
864,Josh McRoberts,459,201,9451,1029,2222,220,649,809,1573,364,510,533,1394,1927,1024,241,205,433,906,2642
865,Josh Minott,15,0,96,18,36,2,6,16,30,8,8,5,20,25,5,4,6,3,10,46
866,Josh Okogie,316,149,6367,672,1678,210,721,462,957,527,704,329,634,963,383,292,133,279,595,2081
867,Josh Powell,118,0,1253,167,408,7,17,160,391,56,76,93,163,256,57,14,12,87,150,397
868,Josh Reaves,4,0,28,3,9,0,2,3,7,2,2,1,2,3,3,0,0,0,5,8
869,Josh Richardson,633,333,17692,2635,6136,1010,2732,1625,3404,964,1140,437,1475,1912,1635,659,331,840,1370,7244
870,Josh Selby,38,0,296,31,94,3,21,28,73,18,25,2,18,20,34,9,0,36,24,83
871,Josh Smith,656,460,19630,3655,8232,436,1478,3219,6754,1347,2326,1137,3464,4601,2161,763,979,1550,1696,9093
872,Joshua Primo,54,16,1058,110,296,45,149,65,147,51,68,34,92,126,99,21,25,68,87,316
873,José Calderón,718,516,18424,2323,5041,877,2102,1446,2939,553,643,237,1456,1693,3794,519,58,1026,1134,6076
874,Jrue Holiday,906,825,30001,5849,12666,1328,3631,4521,9035,1850,2364,838,2864,3702,5868,1346,455,2472,1987,14876
875,Juan Toscano-Anderson,243,46,3773,393,793,89,288,304,505,103,154,122,588,710,433,134,68,213,416,978
876,Juancho Hernangómez,427,99,6547,734,1732,334,975,400,757,328,497,339,1089,1428,276,164,90,215,454,2130
877,Julian Champagnie,34,6,640,118,260,66,164,52,96,28,34,20,100,120,20,12,10,22,52,330
878,Julian Washburn,18,3,254,16,48,5,24,11,24,3,4,8,33,41,14,13,2,7,16,40
879,Julian Wright,120,20,1637,198,392,4,16,194,376,47,84,105,157,262,99,68,38,87,90,447
880,Julius Randle,595,515,18882,4046,8609,666,1985,3380,6624,2369,3179,1166,4415,5581,2158,414,256,1639,1852,11127
881,Julyan Stone,70,2,502,28,63,10,32,18,31,14,20,10,67,77,77,16,8,25,56,80
882,Justin Anderson,333,46,4824,676,1640,232,798,444,842,334,428,214,698,912,283,154,109,215,422,1918
883,Justin Champagnie,46,0,349,41,97,12,38,29,59,9,9,43,45,88,19,10,4,8,36,103
884,Justin Dentmon,14,0,186,20,58,4,28,16,30,8,12,0,16,16,20,4,0,14,20,52
885,Justin Hamilton,162,35,2745,362,775,81,260,281,515,127,156,193,351,544,127,93,103,103,247,932
886,Justin Harper,22,0,150,18,53,8,29,10,24,1,3,5,13,18,4,3,3,12,10,45
887,Justin Holiday,877,436,20998,2548,6456,1446,4021,1102,2435,718,875,318,2095,2413,1272,807,381,765,1470,7260
888,Justin Jackson,400,78,7113,949,2229,362,1110,587,1119,259,324,178,772,950,435,141,59,180,425,2519
889,Justin James,72,0,542,87,195,23,67,64,128,31,57,15,47,62,40,14,12,23,40,228
890,Justin Minaya,4,0,89,7,23,3,12,4,11,0,1,3,12,15,4,2,5,4,9,17
891,Justin Patton,22,6,296,36,89,10,40,26,49,4,6,17,43,60,19,15,14,6,44,86
892,Justin Robinson,68,0,745,68,219,43,141,25,78,11,21,10,44,54,80,21,3,39,66,190
893,Justin Wright-Foreman,4,0,45,7,20,2,10,5,10,3,4,0,5,5,7,2,0,3,5,19
894,Justise Winslow,392,139,9681,1231,2975,244,794,987,2181,397,627,414,1548,1962,973,342,162,549,861,3103
895,Jusuf Nurkić,528,430,12597,2522,5017,75,258,2447,4759,1252,1897,1320,3131,4451,1175,465,607,1132,1633,6371
896,Juwan Howard,165,29,2465,273,574,0,1,273,573,93,116,162,350,512,100,41,15,121,279,639
897,Juwan Morgan,54,0,343,33,62,9,25,24,37,6,11,23,42,65,17,5,3,10,46,81
898,K.J. McDaniels,259,31,3949,527,1278,133,457,394,821,288,372,176,430,606,180,133,182,285,380,1475
899,KZ Okpala,98,12,965,85,208,28,98,57,110,24,36,40,108,148,47,23,26,28,125,222
900,Kadeem Allen,47,2,640,90,207,22,63,68,144,56,74,14,57,71,109,24,8,43,68,258
901,Kai Jones,67,0,613,76,134,5,21,71,113,22,34,40,94,134,19,18,32,37,73,179
902,Kalin Lucas,2,0,12,0,2,0,1,0,1,2,2,0,3,3,1,1,0,0,2,2
903,Kareem Rush,7,0,58,4,11,1,3,3,8,0,0,1,5,6,4,2,3,3,8,9
904,Karim Mané,10,0,88,3,13,1,2,2,11,4,5,1,13,14,4,0,2,3,10,11
905,Karl-Anthony Towns,511,511,17429,4342,8258,839,2125,3503,6133,2249,2694,1496,4205,5701,1626,409,680,1376,1744,11772
906,Kawhi Leonard,628,599,19773,4432,8951,969,2501,3463,6450,2491,2899,753,3274,4027,1876,1085,395,1021,1072,12324
907,Kay Felder,74,0,666,104,298,15,60,89,238,57,73,9,68,77,98,24,9,62,60,280
908,Keegan Murray,80,78,2382,354,782,206,501,148,281,62,81,89,282,371,98,61,42,60,162,976
909,Keifer Sykes,32,11,566,69,190,27,90,42,100,15,17,8,37,45,62,12,4,33,51,180
910,Keita Bates-Diop,274,59,4645,662,1405,159,472,503,933,305,410,202,663,865,233,140,101,156,250,1788
911,Keith Appling,5,0,27,2,8,0,3,2,5,2,2,0,1,1,1,1,0,3,5,6
912,Keith Benson,3,0,9,0,1,0,0,0,1,0,0,2,1,3,0,0,0,0,0,0
913,Keith Bogans,246,156,4577,363,916,250,696,113,220,74,107,65,393,458,278,114,25,147,394,1050
914,Kelan Martin,126,6,1717,273,661,93,306,180,355,57,67,64,220,284,82,43,37,64,158,696
915,Keldon Johnson,224,205,6724,1365,2918,366,1009,999,1909,602,801,239,1005,1244,477,158,51,317,443,3698
916,Kelenna Azubuike,12,7,249,51,96,11,30,40,66,19,28,12,29,41,10,6,9,11,17,132
917,Keljin Blevins,48,1,424,39,131,23,80,16,51,6,11,19,36,55,23,15,1,22,37,107
918,Kelly Olynyk,748,296,17347,2839,5929,953,2615,1886,3314,1307,1639,892,3104,3996,1703,603,363,1184,2134,7938
919,Kelly Oubre Jr.,596,221,15544,2798,6428,918,2796,1880,3632,1274,1689,580,2068,2648,622,601,308,664,1534,7788
920,Kemba Walker,750,697,24810,4999,11954,1670,4642,3329,7312,2818,3354,418,2413,2831,3938,923,282,1574,1111,14486
921,Kendall Brown,6,0,40,4,7,0,1,4,6,1,2,2,4,6,3,4,0,2,9,9
922,Kendall Marshall,160,57,3083,315,789,128,346,187,443,44,72,23,230,253,779,107,10,285,180,802
923,Kendrick Nunn,263,115,5540,1102,2472,417,1157,685,1315,211,242,72,505,577,548,164,43,326,392,2832
924,Kendrick Perkins,515,342,11396,1051,2081,0,7,1051,2074,493,868,798,2227,3025,523,182,467,826,1383,2595
925,Kennedy Chandler,36,0,281,35,83,2,15,33,68,6,13,9,29,38,58,12,5,18,15,78
926,Kenneth Faried,515,398,12456,2346,4274,18,70,2328,4204,1104,1689,1562,2572,4134,490,368,415,659,1262,5814
927,Kenneth Lofton Jr.,24,1,176,49,93,6,17,43,76,16,27,19,32,51,20,5,2,12,28,120
928,Kenny Thomas,26,2,313,17,35,0,0,17,35,7,12,35,51,86,15,10,10,17,42,41
929,Kenrich Williams,253,70,5615,702,1500,220,625,482,875,105,202,362,797,1159,505,216,81,212,519,1729
930,Kent Bazemore,792,346,16145,2276,5545,821,2319,1455,3226,1041,1446,274,2209,2483,1338,775,362,1075,1636,6414
931,Kentavious Caldwell-Pope,759,617,22355,3118,7348,1295,3544,1823,3804,1202,1477,458,1898,2356,1333,860,189,786,1399,8733
932,Kenyon Martin,209,132,5327,693,1440,13,52,680,1388,185,354,334,938,1272,299,205,189,227,587,1584
933,Kenyon Martin Jr.,206,59,5016,851,1561,163,480,688,1081,289,429,279,712,991,272,105,111,189,349,2154
934,Keon Ellis,16,0,71,7,16,6,12,1,4,4,7,4,4,8,6,5,1,1,10,24
935,Keon Johnson,114,24,1809,259,722,96,281,163,441,109,143,59,147,206,211,75,30,135,181,723
936,Kessler Edwards,120,31,1757,182,453,82,246,100,207,38,49,90,204,294,77,57,36,68,165,484
937,Kevin Durant,879,876,32200,8434,16545,1800,4636,6634,11909,6095,6849,546,5896,6442,4105,915,1044,2819,1743,24763
938,Kevin Garnett*,454,454,11735,2146,4304,9,53,2137,4251,816,986,473,2818,3291,988,460,321,610,1024,5117
939,Kevin Hervey,10,0,52,7,27,3,20,4,7,0,0,1,11,12,5,1,1,0,4,17
940,Kevin Huerter,349,291,10325,1608,3624,768,1994,840,1630,281,367,207,1002,1209,1092,333,120,463,825,4265
941,Kevin Jones,32,0,334,43,107,0,0,43,107,9,15,38,40,78,10,9,5,8,25,95
942,Kevin Knox,368,71,6136,904,2292,385,1132,519,1160,368,511,195,827,1022,248,134,86,290,546,2561
943,Kevin Love,855,662,25522,4724,10846,1663,4508,3061,6338,3313,3970,1920,6810,8730,2068,525,316,1569,1615,14424
944,Kevin Martin,506,336,14938,2722,6454,840,2235,1882,4219,2348,2651,211,1224,1435,962,423,51,829,920,8632
945,Kevin Murphy,17,0,52,7,28,1,5,6,23,0,0,0,4,4,2,1,0,3,4,15
946,Kevin Ollie,25,0,263,18,45,0,1,18,44,8,8,3,22,25,20,9,0,6,16,44
947,Kevin Pangos,24,3,166,15,46,6,26,9,20,3,4,2,9,11,30,3,0,7,11,39
948,Kevin Porter Jr.,196,146,5928,1068,2480,399,1117,669,1363,473,652,161,681,842,987,216,61,564,508,3008
949,Kevin Séraphin,423,34,6430,1134,2318,0,7,1134,2311,248,347,502,960,1462,246,88,304,449,903,2516
950,Kevon Harris,34,0,457,47,107,16,43,31,64,31,41,28,42,70,16,17,5,21,53,141
951,Kevon Looney,449,220,7972,976,1678,10,59,966,1619,337,556,952,1558,2510,705,230,256,261,993,2299
952,Keyon Dooling,186,32,3472,411,1027,172,484,239,543,154,193,23,188,211,437,102,6,189,266,1148
953,Khem Birch,349,97,6354,726,1412,27,122,699,1290,405,579,718,910,1628,363,184,204,197,573,1884
954,Khris Middleton,684,595,21493,4211,9207,1267,3264,2944,5943,1944,2205,429,2877,3306,2624,817,128,1433,1734,11633
955,Khyri Thomas,39,2,409,59,152,24,76,35,76,18,24,12,27,39,36,19,11,13,39,160
956,Killian Hayes,168,114,4471,554,1475,144,525,410,950,163,203,70,430,500,885,209,73,367,459,1415
957,Killian Tillie,54,4,643,62,184,37,119,25,65,14,19,27,57,84,30,28,23,15,78,175
958,Kim English,41,0,407,42,112,14,50,28,62,21,29,8,29,37,26,16,3,19,46,119
959,Kira Lewis Jr.,103,0,1480,229,571,68,212,161,359,72,85,26,117,143,196,59,13,70,129,598
960,Kirk Hinrich,557,343,14784,1628,3974,563,1508,1065,2466,552,702,160,1176,1336,1932,492,138,765,1341,4371
961,Klay Thompson,716,679,23560,5304,11649,2213,5318,3091,6331,1335,1567,327,2214,2541,1667,626,378,1219,1497,14156
962,Kobe Bryant*,398,398,14106,3463,8038,623,2018,2840,6020,2274,2744,362,1666,2028,1905,503,96,1258,826,9823
963,Kobi Simmons,38,12,673,81,195,12,44,69,151,27,27,15,39,54,73,18,7,45,61,201
964,Kosta Koufos,688,224,11140,1724,3242,0,6,1724,3236,401,702,1205,2239,3444,346,289,500,484,1387,3849
965,Kostas Antetokounmpo,22,0,87,6,16,0,0,6,16,9,19,6,17,23,3,4,4,13,10,21
966,Kostas Papanikolaou,69,7,1089,93,263,41,138,52,125,22,32,47,111,158,101,42,18,76,95,249
967,Kris Dunn,267,132,6465,932,2157,145,464,787,1693,276,371,108,807,915,1153,401,116,481,782,2285
968,Kris Humphries,634,212,12936,1900,4091,87,284,1813,3807,1089,1483,1243,2797,4040,495,283,436,625,1281,4976
969,Kris Joseph,20,0,108,4,28,0,6,4,22,10,16,2,12,14,2,6,0,4,6,18
970,Kristaps Porziņģis,453,452,13987,3140,6927,815,2306,2325,4621,1811,2176,805,2801,3606,830,329,819,774,1360,8906
971,Kurt Thomas,214,66,3422,312,634,2,2,310,632,52,80,222,647,869,174,92,135,129,498,678
972,Kwame Brown,145,65,2830,294,576,0,1,294,575,191,382,239,519,758,78,55,61,134,325,779
973,Ky Bowman,45,12,1015,134,321,33,107,101,214,34,41,24,97,121,131,44,10,70,102,335
974,Kyle Alexander,2,0,13,1,2,0,0,1,2,0,0,2,1,3,0,0,0,1,1,2
975,Kyle Anderson,574,294,12540,1569,3260,255,739,1314,2521,620,867,440,2148,2588,1502,588,361,586,899,4013
976,Kyle Collinsworth,32,2,480,38,99,4,17,34,82,21,40,32,75,107,56,17,9,24,44,101
977,Kyle Guy,53,0,431,57,158,27,89,30,69,24,32,9,44,53,50,13,1,24,33,165
978,Kyle Korver,904,342,22264,2912,6448,1913,4349,999,2099,771,889,178,2364,2542,1577,524,290,891,1594,8508
979,Kyle Kuzma,406,276,12638,2525,5629,798,2364,1727,3265,845,1166,433,2146,2579,998,231,213,836,850,6693
980,Kyle Lowry,909,801,30388,4587,10842,2014,5413,2573,5429,3112,3768,768,3462,4230,6147,1232,279,2266,2602,14300
981,Kyle O'Quinn,472,65,6714,1085,2099,31,142,1054,1957,367,496,628,1538,2166,643,189,453,458,960,2568
982,Kyle Singler,436,230,9537,1015,2461,395,1067,620,1394,381,486,350,870,1220,357,250,131,333,887,2806
983,Kyle Weaver,17,0,213,21,58,10,26,11,32,12,14,3,25,28,18,8,8,11,16,64
984,Kyle Wiltjer,14,0,44,4,14,4,13,0,1,1,2,4,6,10,2,3,1,5,4,13
985,Kyrie Irving,731,731,25286,6372,13440,1747,4479,4625,8961,2844,3209,593,2354,2947,4165,948,331,1854,1722,17335
986,Kyrylo Fesenko,105,6,881,98,200,0,2,98,198,46,109,69,138,207,34,12,35,49,170,242
987,LaMarcus Aldridge,882,841,29871,7048,14286,250,753,6798,13533,3179,3863,2197,5162,7359,1822,615,972,1380,2012,17525
988,LaMelo Ball,162,142,5159,1127,2647,456,1209,671,1438,439,530,213,821,1034,1188,246,59,519,491,3149
989,Lamar Odom,296,79,7867,1084,2347,172,561,912,1786,384,588,512,1688,2200,741,211,196,427,738,2724
990,Lamar Patterson,40,0,435,31,95,13,55,18,40,18,25,5,52,57,45,10,2,27,51,93
991,Lamar Stevens,165,38,2634,347,743,52,185,295,558,130,183,119,348,467,102,75,50,91,238,876
992,Lance Stephenson,687,214,15227,2314,5157,436,1377,1878,3780,753,1061,400,2253,2653,1978,429,92,1100,1349,5817
993,Lance Thomas,461,165,8813,930,2238,172,455,758,1783,461,586,358,858,1216,335,185,63,340,784,2493
994,Landry Fields,255,176,6010,684,1446,120,361,564,1085,243,365,248,844,1092,419,212,45,270,310,1731
995,Landry Shamet,381,119,8703,1128,2746,772,1954,356,792,394,472,86,587,673,633,179,54,257,698,3422
996,Langston Galloway,533,64,11442,1517,3857,761,2062,756,1795,460,565,242,1038,1280,837,351,70,321,807,4255
997,Larry Drew II,32,1,359,34,106,10,44,24,62,2,3,7,14,21,65,6,0,31,25,80
998,Larry Hughes,99,32,2344,279,794,87,285,192,509,189,228,47,242,289,281,106,30,162,150,834
999,Larry Nance Jr.,573,173,13369,1878,3468,205,623,1673,2845,584,851,1121,2510,3631,1029,671,294,527,1273,4545
1000,Larry Owens,31,0,361,34,75,14,31,20,44,11,22,4,39,43,20,18,11,12,46,93
1001,Larry Sanders,238,113,4635,669,1395,0,5,669,1390,182,329,475,870,1345,174,152,429,224,666,1520
1002,Lauri Markkanen,348,322,10662,2101,4617,829,2237,1272,2380,999,1164,437,2037,2474,477,231,179,482,663,6030
1003,Lavoy Allen,453,89,7977,962,2058,4,28,958,2030,222,327,834,1320,2154,455,144,247,301,832,2150
1004,Lazar Hayward,72,0,591,70,202,21,78,49,124,46,60,25,65,90,35,17,8,28,65,207
1005,LeBron James,949,948,34951,9505,18169,1619,4606,7886,13563,5030,6856,1059,6301,7360,7261,1356,668,3425,1653,25659
1006,Leandro Barbosa,492,8,8850,1656,3764,388,1081,1268,2683,587,719,170,649,819,727,325,68,503,810,4287
1007,Leandro Bolmaro,49,2,309,20,74,5,22,15,52,11,13,20,30,50,28,9,1,20,36,56
1008,Leon Powe,80,8,892,139,287,0,4,139,283,117,207,67,120,187,14,26,10,35,124,395
1009,Lester Hudson,98,0,1059,178,468,49,181,129,287,95,116,30,111,141,120,54,14,102,90,500
1010,Lester Quinones,4,0,18,2,5,2,4,0,1,4,6,1,2,3,2,1,0,5,0,10
1011,Linas Kleiza,108,29,2465,391,960,121,376,270,584,154,203,89,339,428,102,46,13,143,263,1057
1012,Lindell Wigginton,26,1,286,44,98,15,44,29,54,27,44,3,29,32,37,5,3,24,24,130
1013,Lindsey Hunter,13,0,122,5,30,1,13,4,17,2,2,1,13,14,9,1,0,4,12,13
1014,Lindy Waters III,66,1,996,141,353,111,308,30,45,20,25,22,126,148,52,33,19,21,73,413
1015,London Perrantes,14,0,66,2,13,0,3,2,10,3,5,1,3,4,5,2,1,1,6,7
1016,Lonnie Walker IV,264,88,5537,971,2303,348,998,623,1305,316,395,69,532,601,394,142,68,230,355,2606
1017,Lonzo Ball,252,239,8187,1117,2790,595,1633,522,1157,166,287,262,1185,1447,1563,391,162,637,547,2995
1018,Lorenzo Brown,103,7,1185,123,338,18,106,105,232,29,41,28,123,151,183,61,15,74,101,293
1019,Lou Amundson,436,77,5804,657,1455,0,3,657,1452,268,613,666,994,1660,248,165,307,331,881,1582
1020,Lou Williams,1018,127,25907,4969,11830,1557,4346,3412,7484,3991,4653,381,2022,2403,3638,886,190,1829,1280,15486
1021,Louis King,27,1,280,48,115,20,57,28,58,13,20,8,36,44,25,12,4,8,37,129
1022,Luc Mbah a Moute,671,408,14927,1545,3410,211,632,1334,2778,709,1093,829,1630,2459,537,555,232,586,1106,4010
1023,Lucas Nogueira,141,10,1754,182,288,9,34,173,254,73,114,120,268,388,72,89,144,75,221,446
1024,Luguentz Dort,213,204,6300,965,2456,408,1230,557,1226,525,667,228,598,826,357,197,64,281,623,2863
1025,Luis Montero,14,0,50,5,20,1,9,4,11,3,4,0,6,6,1,0,0,6,1,14
1026,Luis Scola,579,384,14489,2900,5973,92,265,2808,5708,1099,1468,961,2735,3696,965,346,194,893,1541,6991
1027,Luka Dončić,330,330,11319,3094,6644,917,2713,2177,3931,1995,2701,328,2497,2825,2631,368,144,1316,753,9100
1028,Luka Garza,60,5,632,129,263,30,88,99,175,79,113,91,72,163,38,12,8,32,98,367
1029,Luka Šamanić,43,9,517,78,178,23,82,55,96,28,46,17,91,108,36,14,12,32,66,207
1030,Luke Babbitt,431,121,6047,741,1808,454,1135,287,673,141,188,118,824,942,255,97,65,184,574,2077
1031,Luke Harangody,119,1,1511,181,477,37,153,144,324,47,64,100,239,339,66,36,37,36,177,446
1032,Luke Kennard,415,102,9603,1445,3144,816,1832,629,1312,352,398,107,1056,1163,785,211,54,369,599,4058
1033,Luke Kornet,263,37,3375,465,1021,162,521,303,500,112,148,201,471,672,231,69,200,90,262,1204
1034,Luke Ridnour,457,229,11107,1583,3558,359,1008,1224,2550,545,633,175,776,951,1719,365,68,660,902,4070
1035,Luke Walton,193,0,2341,187,511,49,158,138,353,19,34,85,263,348,338,71,20,157,237,442
1036,Luke Zeller,16,0,58,9,26,1,5,8,21,0,0,1,9,10,3,0,0,0,5,19
1037,Luol Deng,632,603,22023,3455,7813,646,1927,2809,5886,1693,2190,978,2745,3723,1490,608,274,1005,1015,9249
1038,Luther Head,83,24,1399,204,475,62,169,142,306,87,108,22,118,140,142,28,18,86,96,557
1039,M.J. Walker,2,0,8,0,4,0,2,0,2,0,0,0,1,1,1,2,0,0,1,0
1040,Maalik Wayns,56,2,413,53,178,14,62,39,116,34,38,2,14,16,56,14,0,30,56,154
1041,Mac McClung,6,0,90,15,32,6,17,9,15,5,7,3,13,16,11,2,2,9,13,41
1042,Malachi Flynn,144,21,2156,286,765,131,391,155,374,85,113,35,220,255,277,79,15,81,178,788
1043,Malachi Richardson,96,8,949,97,277,40,133,57,144,53,68,15,89,104,37,26,3,36,90,287
1044,Malaki Branham,66,32,1550,269,611,77,255,192,356,58,70,28,153,181,127,33,7,76,115,673
1045,Malcolm Brogdon,400,258,11796,2279,4885,654,1685,1625,3200,947,1077,314,1364,1678,1844,330,95,691,758,6159
1046,Malcolm Delaney,127,5,2262,254,673,72,234,182,439,149,185,19,204,223,356,74,7,161,194,729
1047,Malcolm Hill,43,0,433,50,108,27,75,23,33,22,28,22,51,73,16,14,6,6,49,149
1048,Malcolm Lee,36,12,534,52,136,10,34,42,102,26,37,24,41,65,51,20,10,27,52,140
1049,Malcolm Miller,53,5,355,36,83,26,64,10,19,10,16,7,29,36,15,7,5,10,33,108
1050,Malcolm Thomas,60,0,449,42,95,2,15,40,80,20,35,37,96,133,20,8,12,37,43,106
1051,Malik Allen,69,3,634,57,147,1,6,56,141,13,15,48,66,114,20,12,9,25,98,128
1052,Malik Beasley,553,155,12421,2245,5380,1252,3341,993,2039,411,511,214,1325,1539,741,360,70,484,680,6153
1053,Malik Fitts,33,0,137,17,41,11,22,6,19,0,0,4,33,37,10,0,0,4,11,45
1054,Malik Hairston,47,0,317,40,76,2,11,38,65,17,30,13,36,49,16,4,9,11,29,99
1055,Malik Monk,386,38,8017,1513,3520,651,1829,862,1691,540,636,134,786,920,925,211,97,535,550,4217
1056,Malik Newman,2,0,12,3,7,0,2,3,5,4,4,0,1,1,1,0,0,2,0,10
1057,Mamadi Diakite,49,6,505,65,137,8,34,57,103,19,27,33,90,123,18,16,24,22,75,157
1058,Mangok Mathiang,4,0,20,4,7,0,0,4,7,0,1,3,7,10,0,1,0,0,5,8
1059,Manny Harris,93,20,1594,199,524,53,150,146,374,124,168,57,196,253,129,48,14,101,104,575
1060,Manu Ginóbili*,579,110,13622,2332,5298,823,2266,1509,3032,1512,1814,289,1465,1754,2297,658,157,1117,1097,6999
1061,MarJon Beauchamp,52,11,701,96,243,47,142,49,101,27,37,38,77,115,35,21,7,45,71,266
1062,MarShon Brooks,235,50,3772,670,1496,122,341,548,1155,289,386,142,336,478,307,134,46,272,290,1751
1063,Marc Gasol,888,863,28634,4675,9847,530,1469,4145,8378,2730,3503,1290,5336,6626,3202,813,1250,1746,2503,12610
1064,Marcelo Huertas,76,1,1106,122,298,20,80,102,218,36,46,20,94,114,234,36,9,99,92,300
1065,Marcin Gortat,817,598,21888,3625,6567,3,23,3622,6544,1258,1831,1803,4933,6736,969,400,922,1012,1848,8511
1066,Marco Belinelli,865,198,20372,3110,7313,1297,3453,1813,3860,1357,1587,194,1641,1835,1474,513,76,873,1225,8874
1067,Marcus Banks,25,0,266,39,75,7,24,32,51,30,37,3,21,24,29,13,2,22,34,115
1068,Marcus Camby,349,309,9122,866,1923,8,25,858,1898,265,461,1018,2470,3488,721,337,568,373,742,2005
1069,Marcus Cousin,4,0,18,2,3,0,0,2,3,0,0,0,3,3,0,0,1,1,1,4
1070,Marcus Derrickson,11,0,67,16,33,10,20,6,13,4,5,8,5,13,1,0,1,3,9,46
1071,Marcus Garrett,12,0,128,5,21,1,4,4,17,2,5,9,14,23,7,5,3,2,16,13
1072,Marcus Georges-Hunt,47,0,272,23,55,5,17,18,38,22,31,8,17,25,10,7,0,5,37,73
1073,Marcus Haislip,10,0,44,10,21,3,5,7,16,2,5,4,6,10,0,0,2,3,5,25
1074,Marcus Landry,36,0,222,32,86,18,56,14,30,6,10,10,28,38,0,2,4,12,28,88
1075,Marcus Morris,922,587,24736,4109,9465,1480,3909,2629,5556,1580,2061,817,3327,4144,1347,622,275,1086,2024,11278
1076,Marcus Paige,5,0,28,4,14,2,8,2,6,2,2,0,4,4,3,0,0,0,0,12
1077,Marcus Smart,581,360,17441,2065,5349,911,2819,1154,2530,1100,1416,481,1577,2058,2700,914,214,1082,1505,6141
1078,Marcus Thornton,737,193,16645,3082,7336,1077,3020,2005,4316,1115,1355,586,1454,2040,1010,601,92,729,1087,8356
1079,Marcus Williams,62,1,872,104,271,24,81,80,190,37,55,13,80,93,161,32,1,74,43,269
1080,Mardy Collins,43,0,470,47,128,4,17,43,111,13,21,13,37,50,44,23,1,32,45,111
1081,Marial Shayok,4,0,28,3,12,2,6,1,6,3,4,1,6,7,1,0,1,3,4,11
1082,Mario Chalmers,625,325,15992,1840,4423,687,1991,1153,2432,1186,1476,198,1316,1514,2239,878,108,1147,1697,5553
1083,Mario Hezonja,330,69,6107,854,2047,266,833,588,1214,310,382,147,879,1026,415,243,80,371,549,2284
1084,Mario West,45,4,258,21,42,1,5,20,37,9,15,10,28,38,19,15,0,9,38,52
1085,Mark Williams,43,17,828,160,251,0,0,160,251,67,97,93,211,304,18,28,45,40,94,387
1086,Markel Brown,113,35,1794,205,539,56,190,149,349,118,151,40,194,234,132,69,27,83,157,584
1087,Markelle Fultz,191,146,5029,942,1996,75,270,867,1726,301,410,156,503,659,964,234,53,386,387,2260
1088,Markieff Morris,965,458,22520,3824,8652,866,2510,2958,6142,1444,1862,1070,3621,4691,1495,721,452,1387,2553,9958
1089,Marko Guduric,44,0,484,62,157,25,83,37,74,24,26,14,59,73,45,12,8,36,34,173
1090,Marko Simonovic,16,0,55,6,22,2,9,4,13,9,13,6,6,12,0,1,1,2,11,23
1091,Markus Howard,68,1,381,79,207,46,135,33,72,27,32,3,30,33,25,13,1,25,40,231
1092,Marques Bolden,7,0,32,1,3,0,0,1,3,5,8,3,5,8,0,3,2,2,1,7
1093,Marquese Chriss,335,149,5837,897,2002,177,627,720,1375,417,622,402,1106,1508,320,204,238,384,819,2388
1094,Marquis Daniels,197,37,3444,422,975,30,131,392,844,130,190,115,309,424,242,138,47,153,267,1004
1095,Marquis Teague,131,6,1352,123,367,15,63,108,304,63,91,6,124,130,192,33,17,116,144,324
1096,Marreese Speights,705,79,10677,2189,4832,233,653,1956,4179,1031,1295,970,1998,2968,478,186,353,648,1558,5642
1097,Marshall Plumlee,29,1,222,17,33,0,0,17,33,20,35,27,41,68,12,4,5,15,33,54
1098,Martell Webster,361,151,8948,1085,2565,511,1317,574,1248,598,736,226,919,1145,412,201,99,334,680,3279
1099,Marvin Bagley III,256,127,6309,1333,2637,136,486,1197,2151,498,737,601,1230,1831,223,123,158,299,530,3300
1100,Marvin Williams,846,620,22299,2797,6362,1022,2787,1775,3575,1151,1411,871,3299,4170,1031,622,481,647,1488,7767
1101,Mason Jones,68,2,719,111,261,49,136,62,125,92,143,15,105,120,88,16,2,59,56,363
1102,Mason Plumlee,900,570,21025,3171,5321,2,47,3169,5274,1696,2945,1989,4394,6383,2385,664,778,1355,2506,8040
1103,Matisse Thybulle,338,128,6670,584,1314,252,740,332,574,105,158,196,466,662,323,480,253,170,652,1525
1104,Matt Barnes,640,273,16365,2031,4688,783,2332,1248,2356,741,969,722,2443,3165,1246,512,350,840,1726,5586
1105,Matt Bonner,427,36,6659,800,1774,456,1089,344,685,136,180,214,854,1068,312,119,109,126,503,2192
1106,Matt Carroll,133,3,1305,159,406,29,108,130,298,76,96,24,114,138,68,38,13,54,109,423
1107,Matt Costello,4,0,32,2,4,0,0,2,4,0,0,1,8,9,2,2,2,1,7,4
1108,Matt Mooney,5,0,21,1,5,0,3,1,2,0,0,0,3,3,1,3,1,1,1,2
1109,Matt Ryan,69,0,625,81,221,65,173,16,48,20,24,8,44,52,32,11,2,14,54,247
1110,Matt Thomas,171,1,1551,228,538,136,350,92,188,49,60,26,173,199,80,26,4,52,92,641
1111,Matt Williams,3,0,11,2,6,1,5,1,1,0,0,0,1,1,0,0,0,1,1,5
1112,Matthew Dellavedova,527,93,10098,992,2565,453,1257,539,1308,355,427,174,714,888,1871,227,23,630,940,2792
1113,Maurice Ager,4,0,29,6,11,3,4,3,7,0,0,0,2,2,1,1,0,4,4,15
1114,Maurice Evans,249,53,4758,574,1353,184,548,390,805,160,190,171,319,490,147,116,45,96,419,1492
1115,Maurice Harkless,720,442,16218,1897,4002,435,1364,1462,2638,581,925,726,1801,2527,684,671,452,596,1499,4810
1116,Maurice Ndour,32,4,331,39,86,1,7,38,79,19,26,22,42,64,8,15,8,12,30,98
1117,Max Christie,41,3,512,44,106,26,62,18,44,14,16,7,68,75,21,9,7,13,33,128
1118,Max Strus,189,49,4372,660,1544,428,1154,232,390,137,167,79,423,502,287,81,30,135,326,1885
1119,Maxi Kleber,363,141,8319,897,2007,445,1244,452,763,288,366,420,1276,1696,397,153,331,246,760,2527
1120,McKinley Wright IV,32,1,354,48,101,10,30,38,71,13,19,9,38,47,61,8,5,20,25,119
1121,Mehmet Okur,103,87,2771,429,976,110,301,319,675,214,264,163,463,626,168,51,90,159,286,1182
1122,Melvin Ely,32,2,393,31,57,0,0,31,57,13,21,27,48,75,14,4,12,14,55,75
1123,Melvin Frazier,32,0,290,35,103,9,43,26,60,8,15,10,18,28,5,11,2,9,25,87
1124,Metta World Peace,387,278,10403,1212,3073,437,1306,775,1767,475,695,413,943,1356,716,477,147,419,810,3336
1125,Meyers Leonard,456,95,7272,972,2016,334,856,638,1160,267,329,333,1438,1771,396,85,127,315,981,2545
1126,Mfiondu Kabengele,94,0,660,82,217,35,123,47,94,39,47,30,111,141,36,20,28,33,84,238
1127,Micah Potter,10,0,83,15,26,4,9,11,17,2,2,7,18,25,4,2,1,3,9,36
1128,Michael Beasley,528,219,11894,2636,5687,258,754,2378,4933,915,1209,554,1868,2422,705,304,277,904,1110,6445
1129,Michael Carter-Williams,489,281,12463,1908,4772,229,907,1679,3865,1095,1565,462,1679,2141,2220,629,260,1189,1179,5140
1130,Michael Finley,92,14,1418,162,368,64,164,98,204,16,30,12,130,142,86,20,12,42,66,404
1131,Michael Foster Jr.,1,0,1,0,0,0,0,0,0,0,0,0,0,0,0,0,0,0,0,0
1132,Michael Frazier,13,0,145,7,29,4,23,3,6,9,14,1,9,10,2,2,0,5,22,27
1133,Michael Gbinije,9,0,32,1,10,0,4,1,6,2,2,2,1,3,2,0,0,0,2,4
1134,Michael Kidd-Gilchrist,471,356,11259,1484,3151,33,123,1451,3028,809,1130,717,1770,2487,529,298,310,416,993,3810
1135,Michael Porter Jr.,187,133,4878,1073,2120,430,1031,643,1089,267,335,230,874,1104,198,114,110,206,361,2843
1136,Michael Redd,79,14,1396,237,618,64,209,173,409,139,181,25,114,139,84,34,3,56,57,677
1137,Mickaël Gelabale,36,13,644,72,139,16,52,56,87,21,24,32,67,99,26,16,4,16,47,181
1138,Mickaël Piétrus,250,54,5208,657,1637,367,1024,290,613,179,272,92,541,633,149,144,89,196,454,1860
1139,Mickell Gladness,52,14,504,50,118,0,0,50,118,12,24,28,88,116,10,8,40,14,64,112
1140,Mikal Bridges,475,408,15587,2496,5108,762,2018,1734,3090,1071,1234,430,1510,1940,1185,585,305,522,948,6825
1141,Mike Bibby,279,220,7322,799,1920,459,1105,340,815,152,211,59,574,633,920,188,24,312,552,2209
1142,Mike Conley,957,947,30788,5052,11530,1641,4293,3411,7237,2679,3249,476,2345,2821,5731,1375,215,1874,1939,14424
1143,Mike Dunleavy,540,223,13364,1789,4089,763,1951,1026,2138,765,932,231,1682,1913,909,292,179,539,920,5106
1144,Mike Harris,50,0,433,54,127,0,4,54,123,42,53,37,49,86,12,26,10,30,66,150
1145,Mike James,156,44,2715,412,1095,120,373,292,722,183,242,41,263,304,496,97,20,197,235,1127
1146,Mike Miller,394,92,7227,770,1717,417,984,353,733,154,197,175,1019,1194,642,149,37,351,571,2111
1147,Mike Muscala,622,58,9890,1364,3035,661,1757,703,1278,492,593,483,1538,2021,554,202,297,351,956,3881
1148,Mike Scott,634,37,10577,1602,3588,595,1617,1007,1971,396,527,421,1582,2003,565,208,87,401,978,4195
1149,Mike Tobey,2,0,25,1,4,0,0,1,4,0,0,2,1,3,1,0,0,1,2,2
1150,Mike Wilks,4,0,59,6,12,2,3,4,9,2,4,1,3,4,4,0,0,4,5,16
1151,Mikki Moore,30,20,524,63,110,0,0,63,110,13,18,33,58,91,41,8,16,28,84,139
1152,Miles Bridges,291,188,8460,1465,3100,434,1255,1031,1845,529,654,326,1315,1641,656,213,216,401,579,3893
1153,Miles McBride,104,4,1132,109,323,57,202,52,121,36,54,17,75,92,113,51,9,30,105,311
1154,Miles Plumlee,464,208,7336,928,1727,0,0,928,1727,248,455,697,1280,1977,233,212,335,389,724,2104
1155,Miloš Teodosić,60,36,1284,168,400,98,259,70,141,43,53,19,123,142,241,26,6,118,130,477
1156,Milton Doyle,10,0,125,13,47,4,23,9,24,4,8,3,15,18,10,6,2,2,13,34
1157,Mindaugas Kuzminskas,69,5,1018,158,371,54,168,104,203,55,68,47,79,126,69,29,11,51,79,425
1158,Miroslav Raduljica,53,2,488,71,134,0,0,71,134,47,57,56,57,113,23,8,13,30,92,189
1159,Mirza Teletović,324,14,5765,927,2285,541,1460,386,825,241,319,189,853,1042,273,104,82,255,552,2636
1160,Mitch Creek,10,0,96,16,32,0,4,16,28,10,14,12,12,24,12,4,0,2,6,42
1161,Mitch McGary,52,2,557,99,188,0,6,99,182,29,50,57,126,183,17,17,18,38,82,227
1162,Mitchell Robinson,289,175,7064,1019,1431,0,0,1019,1431,338,639,1038,1237,2275,181,253,567,199,852,2376
1163,Miye Oni,80,1,672,49,140,38,115,11,25,9,12,29,79,108,37,15,10,21,77,145
1164,Mo Bamba,324,89,5731,921,1929,299,824,622,1105,252,372,504,1318,1822,293,114,412,258,697,2393
1165,Mo Williams,534,307,15367,2543,6153,826,2275,1717,3878,1068,1222,209,1085,1294,2840,434,100,1276,1259,6980
1166,Monta Ellis,659,618,23644,4715,10743,712,2247,4003,8496,2181,2810,309,1905,2214,3397,1167,232,1904,1545,12323
1167,Monte Morris,342,166,8761,1417,2949,412,1052,1005,1897,337,406,123,742,865,1368,264,61,278,391,3583
1168,Montrezl Harrell,586,39,12185,2864,4605,13,100,2851,4505,1411,2103,1079,1940,3019,820,298,447,622,1195,7152
1169,Moritz Wagner,298,79,4794,819,1687,226,703,593,984,520,633,238,849,1087,351,148,94,315,684,2384
1170,Morris Almond,4,0,67,6,17,1,3,5,14,1,3,1,7,8,2,7,0,1,6,14
1171,Morris Peterson,50,39,996,118,306,62,172,56,134,33,54,17,112,129,42,25,5,27,86,331
1172,Moses Brown,204,46,2230,400,686,0,0,400,686,233,422,349,596,945,21,54,108,116,284,1033
1173,Moses Moody,115,14,1424,188,410,89,245,99,165,65,89,45,140,185,74,25,17,47,97,530
1174,Moses Wright,8,0,29,2,8,0,2,2,6,6,6,2,4,6,4,0,2,0,0,10
1175,Moussa Diabaté,22,1,195,24,47,1,2,23,45,10,16,31,19,50,4,7,8,9,15,59
1176,Mustafa Shakur,25,0,170,21,62,1,11,20,51,9,17,7,15,22,29,5,3,20,17,52
1177,Mychal Mulder,101,15,1449,193,486,135,374,58,112,31,42,15,116,131,44,22,17,37,102,552
1178,Mychel Thompson,5,3,95,7,24,4,11,3,13,0,0,0,5,5,7,2,1,5,8,18
1179,Myke Henry,20,0,378,41,109,19,58,22,51,6,10,10,28,38,22,31,6,19,28,107
1180,Myles Powell,11,0,52,5,17,1,6,4,11,2,2,1,5,6,3,1,0,3,8,13
1181,Myles Turner,493,460,14204,2470,4963,484,1370,1986,3593,1174,1523,703,2642,3345,602,347,1124,677,1466,6598
1182,Naji Marshall,164,35,3227,438,1049,116,406,322,643,265,343,101,468,569,339,113,32,181,240,1257
1183,Nando De Colo,166,12,1908,233,547,67,188,166,359,97,114,51,233,284,268,85,18,151,183,630
1184,Nassir Little,192,34,3277,422,936,151,451,271,485,166,229,148,465,613,149,63,83,109,271,1161
1185,Nate Darling,7,0,26,2,7,2,7,0,0,3,3,1,0,1,1,0,1,1,1,9
1186,Nate Hinton,23,0,95,15,43,4,19,11,24,7,10,1,8,9,8,7,2,6,8,41
1187,Nate Robinson,493,62,9605,1674,4037,631,1754,1043,2283,534,681,185,680,865,1447,377,40,619,1036,4513
1188,Nate Wolters,105,31,1822,211,509,18,76,193,433,63,102,50,169,219,230,51,19,83,104,503
1189,Nathan Jawai,39,2,412,49,111,0,1,49,110,26,38,49,55,104,24,10,9,27,58,124
1190,Nathan Knight,108,2,837,128,269,18,68,110,201,127,172,81,132,213,43,26,24,54,105,401
1191,Naz Mitrou-Long,20,0,132,13,38,5,24,8,14,2,2,1,12,13,23,2,2,11,12,33
1192,Naz Reid,245,43,4308,947,1877,225,654,722,1223,352,495,291,789,1080,255,135,222,265,610,2471
1193,Nazr Mohammed,442,117,5638,872,1748,0,5,872,1743,281,454,604,1018,1622,137,134,259,290,768,2025
1194,Neemias Queta,20,0,149,23,47,0,0,23,47,11,19,19,23,42,7,1,10,7,25,57
1195,Nemanja Bjelica,486,165,9768,1368,2942,525,1381,843,1561,393,520,515,1663,2178,895,303,189,492,1126,3654
1196,Nemanja Nedović,24,0,142,8,39,3,18,5,21,7,8,3,12,15,13,0,1,13,13,26
1197,Nenad Krstić,218,210,4883,743,1464,1,5,742,1459,302,398,382,671,1053,106,84,95,170,545,1789
1198,Nenê,634,392,15774,2786,5082,6,43,2780,5039,1600,2427,922,2744,3666,1198,624,431,1029,1753,7178
1199,Nerlens Noel,535,246,11523,1572,2863,4,18,1568,2845,670,1016,1001,2174,3175,561,669,743,657,1350,3818
1200,Nic Claxton,170,96,4026,709,1044,2,14,707,1030,229,424,337,839,1176,231,113,288,161,404,1649
1201,Nick Calathes,129,7,2011,246,558,30,104,216,454,68,117,42,201,243,353,129,13,162,217,590
1202,Nick Collison,531,15,9327,932,1693,21,89,911,1604,377,532,803,1269,2072,572,245,208,425,1264,2262
1203,Nick Johnson,28,0,262,26,75,5,21,21,54,17,25,13,26,39,11,7,3,19,34,74
1204,Nick Richards,133,14,1647,261,412,1,2,260,410,174,237,185,328,513,53,20,92,86,212,697
1205,Nick Young,625,229,15153,2664,6470,1046,2782,1618,3688,1246,1488,237,1058,1295,585,364,125,608,1187,7620
1206,Nickeil Alexander-Walker,341,62,6298,1058,2674,454,1346,604,1328,315,441,126,678,804,719,220,118,419,527,2885
1207,Nico Mannion,30,1,364,39,114,22,60,17,54,23,28,6,40,46,70,16,1,31,29,123
1208,Nicolas Batum,914,749,28286,3614,8289,1527,4187,2087,4102,1446,1734,892,3894,4786,3262,878,583,1542,1590,10201
1209,Nicolás Brussino,58,2,531,52,143,29,97,23,46,17,22,26,72,98,47,17,8,26,43,150
1210,Nicolás Laprovíttola,18,3,174,20,47,10,27,10,20,9,9,1,9,10,28,4,1,19,19,59
1211,Nicolò Melli,150,16,2174,228,605,115,376,113,229,92,123,96,328,424,170,62,29,70,240,663
1212,Nigel Hayes,18,0,244,22,66,8,32,14,34,2,6,8,36,44,12,4,6,4,16,54
1213,Nigel Williams-Goss,10,0,50,5,16,2,7,3,9,2,2,2,4,6,6,3,1,3,6,14
1214,Nik Stauskas,460,63,8278,971,2487,514,1429,457,1058,432,530,101,784,885,637,169,91,418,501,2888
1215,Nikola Jokić,596,555,18341,4628,8367,593,1702,4035,6665,2205,2661,1560,4713,6273,3959,714,423,1709,1641,12054
1216,Nikola Jović,15,8,204,28,69,8,35,20,34,18,19,9,22,31,10,7,2,10,19,82
1217,Nikola Mirotić,420,134,10457,1847,4310,865,2388,982,1922,907,1115,420,2218,2638,542,315,301,491,881,5466
1218,Nikola Peković,271,194,6744,1314,2537,0,0,1314,2537,777,1023,803,1004,1807,199,140,151,414,632,3405
1219,Nikola Vučević,893,832,27963,6660,13480,853,2383,5807,11097,1466,1904,2192,7259,9451,2571,775,780,1557,2141,15639
1220,Noah Vonleh,452,189,7106,807,1743,116,384,691,1359,351,509,595,1630,2225,326,169,167,330,753,2081
1221,Nolan Smith,84,4,829,109,294,19,73,90,221,40,56,24,59,83,97,25,4,71,81,277
1222,Norman Powell,595,295,14653,2737,5863,990,2516,1747,3347,1467,1764,246,1377,1623,959,515,170,787,1158,7931
1223,Norris Cole,435,85,9849,1235,3027,262,815,973,2212,347,470,92,769,861,1236,337,49,616,803,3079
1224,Norvel Pelle,53,0,419,44,83,0,1,44,82,15,26,35,81,116,12,5,50,26,84,103
1225,O.J. Mayo,465,243,13799,2246,5264,709,1909,1537,3355,857,1065,229,1169,1398,1345,468,128,904,1035,6058
1226,OG Anunoby,368,294,10446,1611,3417,590,1572,1021,1845,456,613,405,1173,1578,560,459,188,466,882,4268
1227,Obi Toppin,201,15,2963,542,1101,163,501,379,600,151,197,124,469,593,172,65,60,117,225,1398
1228,Ochai Agbaji,59,22,1209,165,386,81,228,84,158,56,69,43,78,121,67,16,15,41,99,467
1229,Ognjen Kuzmić,37,0,164,13,25,0,0,13,25,9,15,17,21,38,8,5,5,15,30,35
1230,Okaro White,44,4,557,40,105,16,47,24,58,22,25,29,66,95,23,11,11,19,58,118
1231,Oleksiy Pecherov,44,5,447,77,188,14,52,63,136,29,32,32,92,124,11,9,14,32,55,197
1232,Oliver Lafayette,1,0,22,3,6,1,2,2,4,0,0,1,3,4,2,0,0,1,0,7
1233,Olivier Sarr,31,3,535,73,131,14,37,59,94,29,36,46,78,124,23,7,20,26,69,189
1234,Omari Johnson,4,0,75,9,21,4,12,5,9,0,0,4,7,11,7,2,0,3,6,22
1235,Omari Spellman,95,14,1691,225,539,87,238,138,301,105,137,149,264,413,94,59,49,85,130,642
1236,Omer Yurtseven,65,12,789,146,274,4,18,142,256,43,67,93,224,317,51,19,22,45,100,339
1237,Omri Casspi,624,147,12602,1795,3945,508,1382,1287,2563,730,1081,500,1967,2467,699,385,137,624,967,4828
1238,Onyeka Okongwu,178,28,3442,569,872,4,16,565,856,269,363,394,628,1022,152,110,200,154,500,1411
1239,Orien Greene,3,0,5,1,2,0,0,1,2,1,2,0,0,0,1,1,0,0,0,3
1240,Orlando Johnson,155,2,1605,162,474,58,208,104,266,73,100,46,204,250,91,29,19,67,121,455
1241,Orlando Robinson,31,1,425,47,89,0,6,47,83,22,31,48,78,126,25,12,12,16,53,116
1242,Oshae Brissett,172,43,3301,417,1012,167,485,250,527,276,384,208,509,717,141,100,63,105,245,1277
1243,Othello Hunter,7,0,33,4,12,0,0,4,12,3,4,6,6,12,0,0,1,3,5,11
1244,Othyus Jeffers,60,4,811,80,171,2,12,78,159,79,119,60,111,171,43,38,0,36,80,241
1245,Otto Porter Jr.,596,367,15515,2471,5213,819,2061,1652,3152,670,836,678,2358,3036,950,679,251,487,1049,6431
1246,Ousmane Dieng,39,1,569,76,181,26,98,50,83,15,23,19,86,105,46,14,7,26,42,193
1247,P.J. Hairston,177,106,3313,377,1085,189,645,188,440,131,164,72,368,440,97,85,35,104,335,1074
1248,P.J. Tucker,968,710,27958,2364,5598,974,2678,1390,2920,803,1065,1429,3908,5337,1366,1079,294,907,2399,6505
1249,P.J. Washington,260,219,7861,1254,2785,457,1249,797,1536,381,536,306,1123,1429,606,243,263,413,674,3346
1250,PJ Dozier,121,6,1973,268,667,83,270,185,397,74,110,66,266,332,199,64,35,92,174,693
1251,Pablo Prigioni,337,54,5763,425,1014,260,701,165,313,110,127,175,449,624,936,347,7,319,517,1220
1252,Paolo Banchero,72,72,2430,479,1122,85,285,394,837,394,534,84,413,497,269,60,39,200,160,1437
1253,Pape Sy,3,0,21,2,6,0,1,2,5,3,3,2,1,3,2,1,0,3,1,7
1254,Paris Bass,2,0,7,2,6,0,2,2,4,2,2,2,2,4,0,1,0,2,2,6
1255,Pascal Siakam,471,377,14432,3038,6233,481,1469,2557,4764,1453,1878,685,2393,3078,1656,436,307,882,1313,8010
1256,Pat Connaughton,478,68,9160,1075,2466,573,1594,502,872,212,273,336,1339,1675,598,234,129,256,554,2935
1257,Patricio Garino,5,0,43,0,7,0,5,0,2,0,0,1,6,7,0,0,0,3,4,0
1258,Patrick Baldwin Jr.,31,0,226,43,109,32,84,11,25,4,6,1,39,40,11,6,4,11,14,122
1259,Patrick Beverley,660,572,18043,1915,4652,992,2681,923,1971,662,881,680,2057,2737,2227,728,353,787,2006,5484
1260,Patrick Christopher,4,1,29,3,12,0,4,3,8,0,0,2,4,6,0,1,0,1,6,6
1261,Patrick Ewing,7,0,19,0,5,0,2,0,3,3,4,1,1,2,2,0,1,1,1,3
1262,Patrick McCaw,228,44,3770,318,759,101,330,217,429,97,122,71,296,367,299,162,33,140,271,834
1263,Patrick O'Bryant,11,0,51,8,15,0,1,8,14,3,6,2,9,11,1,2,4,5,12,19
1264,Patrick Patterson,855,158,18231,2415,5297,736,1992,1679,3305,508,677,1052,2426,3478,895,454,373,576,1413,6074
1265,Patrick Williams,170,145,4728,623,1307,184,444,439,863,211,271,161,562,723,214,145,125,215,301,1641
1266,Patty Mills,860,107,17580,2773,6515,1496,3850,1277,2665,724,848,255,1179,1434,1950,548,76,828,1108,7766
1267,Pau Gasol,672,578,20540,3910,7912,167,422,3743,7490,2023,2613,1584,4771,6355,2125,298,956,1215,1283,10010
1268,Paul Davis,2,0,8,2,4,0,0,2,4,1,2,0,0,0,3,0,1,0,0,5
1269,Paul George,793,745,26680,5573,12747,2010,5271,3563,7476,3205,3772,689,4388,5077,2929,1351,344,2164,2115,16361
1270,Paul Millsap,878,706,25410,4638,9624,548,1612,4090,8012,2579,3451,1783,4467,6250,2126,1120,838,1538,2522,12403
1271,Paul Pierce*,530,475,15355,2572,5705,785,2103,1787,3602,1865,2248,239,2181,2420,1525,487,215,1043,1303,7794
1272,Paul Reed,133,4,1234,220,383,3,20,217,363,48,73,186,229,415,55,89,78,67,209,491
1273,Paul Watson,56,5,627,70,169,44,114,26,55,20,28,11,95,106,41,17,8,19,56,204
1274,Paul Zipser,98,30,1667,169,455,70,209,99,246,50,65,28,228,256,82,35,31,83,164,458
1275,Payton Pritchard,185,9,2912,445,1036,259,647,186,389,73,82,90,290,380,323,76,16,134,202,1222
1276,Peja Stojaković,128,81,3181,478,1142,246,624,232,518,142,157,67,310,377,150,74,9,90,131,1344
1277,Pero Antić,113,29,1962,231,590,108,344,123,246,138,189,115,283,398,107,37,26,104,258,708
1278,Perry Jones,143,21,1675,195,464,36,123,159,341,62,94,46,206,252,54,36,33,60,135,488
1279,Petr Cornelie,13,0,38,5,15,1,8,4,7,3,4,7,7,14,3,1,1,4,7,14
1280,Peyton Siva,24,0,224,18,57,7,25,11,32,11,15,2,12,14,34,9,1,18,27,54
1281,Peyton Watson,23,2,186,29,59,6,14,23,45,11,20,8,29,37,11,2,11,8,14,75
1282,Phil Pressey,171,11,2298,202,583,52,207,150,376,88,144,39,208,247,508,134,19,194,207,544
1283,Pierre Jackson,8,1,84,13,39,3,11,10,28,6,7,1,8,9,19,2,0,3,5,35
1284,Pops Mensah-Bonsu,47,0,275,27,69,0,0,27,69,26,48,35,46,81,8,8,18,22,51,80
1285,Precious Achiuwa,189,44,3602,585,1235,85,265,500,970,221,365,319,690,1009,161,88,99,186,344,1476
1286,Primož Brezec,42,0,190,18,52,0,0,18,52,2,12,24,26,50,2,2,6,4,38,38
1287,Quentin Grimes,117,72,2907,377,837,229,596,148,241,91,117,73,250,323,194,78,37,97,249,1074
1288,Quentin Richardson,182,97,3932,404,1024,227,629,177,395,112,147,123,562,685,170,123,29,126,318,1147
1289,Quenton Jackson,9,0,135,19,42,1,12,18,30,17,22,2,6,8,15,4,1,4,10,56
1290,Quincy Acy,438,61,6797,719,1625,224,628,495,997,373,499,401,1109,1510,263,177,176,270,854,2035
1291,Quincy Miller,79,16,1053,116,344,36,131,80,213,56,79,45,144,189,45,37,42,59,91,324
1292,Quincy Pondexter,430,78,7323,759,1798,302,837,457,961,327,439,253,582,835,357,141,73,229,614,2147
1293,Quinn Cook,225,29,2997,541,1173,202,493,339,680,71,91,49,289,338,342,60,8,155,224,1355
1294,Quinndary Weatherspoon,42,0,272,33,73,3,16,30,57,19,23,6,26,32,24,12,4,18,41,88
1295,Quinton Ross,140,18,1477,106,281,8,45,98,236,21,42,44,84,128,34,29,18,29,178,241
1296,R.J. Hampton,260,22,4678,651,1557,200,589,451,968,299,433,117,609,726,440,138,51,277,325,1801
1297,R.J. Hunter,45,1,395,49,132,26,88,23,44,9,11,3,43,46,19,18,4,13,39,133
1298,RJ Barrett,271,270,9107,1756,4157,446,1300,1310,2857,942,1328,244,1225,1469,769,182,68,578,631,4900
1299,RJ Nembhard Jr.,14,0,63,6,18,0,2,6,16,3,4,3,4,7,12,1,0,3,2,15
1300,Rafer Alston,104,76,2842,310,892,116,336,194,556,118,162,26,232,258,352,100,20,190,206,854
1301,RaiQuan Gray,1,0,35,6,12,2,5,4,7,2,2,3,6,9,7,0,1,4,5,16
1302,Raja Bell,114,106,3253,328,763,126,334,202,429,118,133,47,224,271,182,77,20,94,277,900
1303,Rajon Rondo,874,623,25278,3402,7630,517,1551,2885,6079,784,1320,764,3146,3910,7142,1270,110,2450,1698,8105
1304,Rakeem Christmas,30,0,225,21,45,0,0,21,45,21,29,27,30,57,4,3,6,8,38,63
1305,Ramon Sessions,834,155,18997,2749,6432,304,924,2445,5508,2505,3168,367,1745,2112,3181,508,56,1390,1050,8307
1306,Randolph Morris,28,0,124,23,41,0,0,23,41,16,27,10,28,38,2,5,3,12,34,62
1307,Randy Foye,642,337,15289,1976,5098,939,2626,1037,2472,831,974,173,1109,1282,1574,406,199,811,1228,5722
1308,Rashad Vaughn,167,8,1883,184,534,97,302,87,232,22,32,21,158,179,88,58,32,54,135,487
1309,Rashard Lewis,329,206,8509,1140,2675,455,1243,685,1432,384,487,281,957,1238,405,279,120,382,704,3119
1310,Rasheed Wallace,100,13,2076,321,792,104,359,217,433,110,145,53,355,408,86,93,85,73,262,856
1311,Rasho Nesterović,42,8,413,81,149,0,0,81,149,1,5,37,52,89,25,10,17,16,54,163
1312,Rasual Butler,381,85,7010,873,2208,390,1127,483,1081,237,308,101,653,754,293,108,157,209,373,2373
1313,Raul Neto,435,99,6765,935,2041,258,714,677,1327,342,421,96,562,658,913,279,34,398,569,2470
1314,Rawle Alkins,10,1,120,13,39,3,12,10,27,8,12,11,15,26,13,1,0,8,7,37
1315,Ray Allen*,358,211,11245,1702,3638,674,1652,1028,1986,766,852,173,918,1091,816,311,72,501,656,4844
1316,Ray McCallum,195,52,3283,429,1062,86,254,343,808,113,157,86,267,353,428,91,34,172,219,1057
1317,Ray Spalding,30,6,315,52,98,0,7,52,91,8,26,32,68,100,10,18,18,21,49,112
1318,Rayjon Tucker,44,0,371,41,79,13,34,28,45,43,56,10,37,47,31,11,1,14,28,138
1319,Raymond Felton,727,424,20270,2940,6977,726,2152,2214,4825,1068,1341,381,1677,2058,3594,827,158,1376,1284,7674
1320,Reggie Bullock,611,356,14356,1676,3977,1015,2656,661,1321,356,429,205,1396,1601,769,356,92,364,882,4723
1321,Reggie Evans,349,122,6409,435,942,0,3,435,939,428,798,836,1740,2576,180,244,40,377,779,1298
1322,Reggie Hearn,3,0,7,1,2,1,2,0,0,0,0,0,0,0,0,0,0,0,0,3
1323,Reggie Jackson,947,602,24326,4514,10676,1269,3711,3245,6965,1759,2056,490,2339,2829,4074,655,114,1792,1834,12056
1324,Reggie Perry,46,2,585,112,236,10,53,102,183,28,43,57,110,167,38,24,18,37,106,262
1325,Reggie Williams,206,32,3736,599,1313,199,545,400,768,201,268,105,388,493,301,88,13,142,241,1598
1326,Renaldo Balkman,43,1,330,34,76,4,20,30,56,16,25,14,49,63,16,20,9,14,60,88
1327,Richard Hamilton,179,158,4835,925,2173,129,380,796,1793,445,527,90,307,397,576,105,13,336,359,2424
1328,Richard Jefferson,673,354,15603,1880,4189,753,1899,1127,2290,855,1183,257,1681,1938,815,320,169,567,1205,5368
1329,Richaun Holmes,418,161,8271,1543,2548,48,176,1495,2372,601,805,721,1526,2247,412,223,407,361,1079,3735
1330,Ricky Davis,36,2,499,62,143,16,42,46,101,18,31,10,47,57,39,11,3,29,39,158
1331,Ricky Ledo,45,0,521,70,209,23,62,47,147,36,48,32,42,74,40,13,2,54,44,199
1332,Ricky Rubio,698,603,20694,2468,6364,637,1969,1831,4395,1997,2370,428,2402,2830,5160,1226,94,1768,1738,7570
1333,Rob Edwards,2,0,11,1,4,1,4,0,0,0,0,0,3,3,0,0,0,1,0,3
1334,Robbie Hummel,98,9,1397,146,349,48,140,98,209,39,45,66,200,266,50,32,11,28,143,379
1335,Robert Covington,761,605,22125,2862,6954,1618,4481,1244,2473,1107,1370,671,3664,4335,1086,1191,791,1075,2218,8449
1336,Robert Franks,7,0,101,13,28,5,15,8,13,12,13,6,8,14,5,3,3,2,8,43
1337,Robert Sacre,189,35,2745,318,729,0,1,318,728,151,225,212,381,593,126,56,110,102,336,787
1338,Robert Williams,209,97,4284,684,935,0,4,684,931,166,253,542,905,1447,299,152,348,180,397,1534
1339,Robert Woodard II,25,0,87,10,36,2,10,8,26,5,10,9,18,27,5,1,4,2,7,27
1340,Robin Lopez,916,598,20258,3406,6332,55,183,3351,6149,1252,1681,2092,2445,4537,807,207,1001,1033,1754,8119
1341,Rodions Kurucs,152,55,2228,303,690,103,316,200,374,102,138,91,338,429,123,84,38,149,268,811
1342,Rodney Carney,122,2,1529,205,502,75,211,130,291,88,117,52,181,233,59,49,30,53,145,573
1343,Rodney Hood,687,330,16137,2454,5862,922,2543,1532,3319,922,1084,243,1419,1662,1048,444,117,598,1211,6752
1344,Rodney McGruder,317,132,6158,681,1622,301,836,380,786,162,241,253,632,885,381,161,50,190,459,1825
1345,Rodney Purvis,16,2,290,35,107,13,52,22,55,13,15,1,26,27,17,3,3,10,26,96
1346,Rodney Stuckey,515,235,14292,2350,5575,250,827,2100,4748,1741,2105,318,1190,1508,1786,441,77,930,1016,6691
1347,Rodrigue Beaubois,182,54,2896,502,1143,129,397,373,746,153,189,47,291,338,374,124,52,204,312,1286
1348,Roger Mason,251,20,4010,479,1203,246,669,233,534,101,121,35,393,428,297,81,33,157,287,1305
1349,Roko Ukić,13,0,97,14,30,3,12,11,18,9,11,0,3,3,12,1,0,6,6,40
1350,Romeo Langford,189,37,3039,336,780,84,276,252,504,112,177,144,262,406,118,82,58,83,218,868
1351,Ron Baker,111,14,1546,110,316,36,145,74,171,58,81,19,131,150,184,72,16,84,143,314
1352,Ron Harper Jr.,9,0,48,8,16,3,9,5,7,1,1,3,4,7,4,0,1,0,3,20
1353,Ronald Dupree,3,0,13,1,4,0,1,1,3,0,0,0,3,3,1,0,0,0,2,2
1354,Ronald Murray,150,4,3346,536,1366,138,442,398,924,282,388,56,310,366,270,92,32,182,252,1492
1355,Rondae Hollis-Jefferson,305,154,6759,1004,2238,44,208,960,2030,708,963,440,1244,1684,579,278,162,392,620,2760
1356,Ronnie Brewer,431,224,8926,959,2156,89,326,870,1830,345,581,305,870,1175,705,458,87,260,380,2352
1357,Ronnie Price,344,52,5254,485,1343,172,580,313,763,186,250,136,321,457,715,319,44,342,691,1328
1358,Ronny Turiaf,238,61,3897,339,579,0,3,339,576,168,333,258,607,865,263,113,246,171,481,846
1359,Roy Hibbert,640,557,16062,2504,5368,6,24,2498,5344,1324,1730,1466,2616,4082,857,229,1116,1015,1952,6338
1360,Royal Ivey,202,5,1864,174,423,90,228,84,195,30,50,31,135,166,103,81,8,56,205,468
1361,Royce O'Neale,446,283,11926,1048,2423,591,1541,457,882,269,344,281,1866,2147,1054,357,185,462,1083,2956
1362,Royce White,3,0,9,0,1,0,0,0,1,0,0,0,0,0,0,0,0,0,2,0
1363,Rudy Fernández,171,6,3972,472,1223,254,749,218,474,241,287,81,320,401,395,180,28,200,258,1439
1364,Rudy Gay,1030,724,31731,6210,13826,1064,3114,5146,10712,3010,3711,1317,4580,5897,2298,1159,695,2134,2234,16494
1365,Rudy Gobert,681,589,20449,3156,4826,0,14,3156,4812,2219,3474,2254,5679,7933,894,468,1452,1130,1789,8531
1366,Rui Hachimura,273,136,7116,1319,2742,227,667,1092,2075,462,605,258,1074,1332,333,142,76,260,422,3327
1367,Russ Smith,39,0,196,23,72,5,27,18,45,32,39,3,18,21,27,11,1,31,31,83
1368,Russell Westbrook,1085,987,37010,8750,19892,1285,4189,7465,15703,5575,7238,1690,6298,7988,9278,1741,363,4424,2819,24360
1369,Ryan Anderson,608,267,15779,2616,6195,1265,3342,1351,2853,1080,1266,1161,1995,3156,553,292,198,557,1131,7577
1370,Ryan Arcidiacono,257,44,4065,367,882,189,508,178,374,134,166,53,406,459,506,125,7,140,371,1057
1371,Ryan Bowen,1,0,8,1,1,0,0,1,1,2,2,1,1,2,0,1,0,0,2,4
1372,Ryan Broekhoff,59,1,633,79,185,58,144,21,41,22,27,13,93,106,33,11,8,22,50,238
1373,Ryan Gomes,189,128,4764,568,1340,150,441,418,899,173,222,151,516,667,255,140,28,166,353,1459
1374,Ryan Hollins,462,92,5955,666,1116,0,1,666,1115,482,753,428,657,1085,148,84,240,378,963,1814
1375,Ryan Kelly,163,59,3125,324,857,102,323,222,534,231,290,77,427,504,215,79,84,106,309,981
1376,Ryan Reid,5,0,17,4,5,0,0,4,5,0,0,1,1,2,0,0,0,1,1,8
1377,Ryan Rollins,12,0,62,7,20,3,9,4,11,6,6,3,9,12,6,1,1,16,10,23
1378,Saben Lee,135,9,2131,266,629,44,143,222,486,201,274,64,210,274,415,106,27,139,184,777
1379,Saddiq Bey,306,209,8871,1435,3499,688,1906,747,1593,744,877,346,1137,1483,564,265,56,298,484,4302
1380,Salah Mejri,204,22,2430,280,464,12,41,268,423,121,205,259,549,808,94,72,190,123,382,693
1381,Sam Dekker,248,13,3885,571,1200,108,371,463,829,131,216,244,511,755,206,139,44,122,248,1381
1382,Sam Hauser,106,8,1448,203,446,159,379,44,67,12,17,40,193,233,81,30,23,32,106,577
1383,Sam Merrill,41,2,350,49,118,33,88,16,30,8,10,7,39,46,30,12,1,12,23,139
1384,Sam Young,284,54,4341,605,1393,54,192,551,1201,286,386,183,452,635,195,151,63,220,334,1550
1385,Samardo Samuels,109,11,1722,237,532,0,4,237,528,164,251,148,218,366,45,38,41,115,231,638
1386,Samuel Dalembert,386,283,8431,1161,2245,1,5,1160,2240,448,606,967,1915,2882,252,187,566,517,1009,2771
1387,Sandro Mamukelashvili,127,17,1727,251,575,82,250,169,325,96,136,175,277,452,146,37,33,85,132,680
1388,Santi Aldama,109,20,2042,300,657,100,314,200,343,128,176,118,340,458,118,51,58,76,179,828
1389,Sasha Kaun,25,0,95,9,17,0,0,9,17,5,11,12,14,26,3,4,5,7,11,23
1390,Sasha Pavlović,217,22,2656,259,691,94,298,165,393,26,60,25,284,309,140,87,40,111,265,638
1391,Sasha Vujačić,306,64,5197,694,1772,295,824,399,948,239,288,123,539,662,441,176,21,212,461,1922
1392,Scott Machado,10,0,40,7,12,1,2,6,10,3,3,0,1,1,9,3,0,8,2,18
1393,Scottie Barnes,151,150,5295,922,1948,121,417,801,1531,348,461,374,695,1069,627,163,116,290,362,2313
1394,Scottie Lewis,2,0,7,0,0,0,0,0,0,1,2,0,0,0,1,1,0,0,0,1
1395,Scotty Hopson,4,0,33,2,9,0,3,2,6,2,4,0,1,1,3,1,0,3,1,6
1396,Scotty Pippen Jr.,6,0,32,4,12,1,3,3,9,5,9,2,2,4,2,2,1,2,3,14
1397,Sean Kilpatrick,240,26,4338,778,1883,279,837,499,1046,456,524,57,515,572,311,98,20,275,261,2291
1398,Sean Marks,43,0,283,23,52,2,2,21,50,7,13,30,33,63,6,3,8,13,61,55
1399,Sean May,37,4,331,51,111,0,4,51,107,21,32,20,50,70,17,12,7,19,46,123
1400,Sean McDermott,18,0,158,13,33,5,22,8,11,8,8,6,13,19,4,2,3,4,8,39
1401,Sean Williams,42,0,441,49,93,0,1,49,92,34,45,47,49,96,11,16,35,40,77,132
1402,Sebastian Telfair,317,16,5211,674,1728,211,655,463,1073,287,373,75,358,433,852,198,47,378,563,1846
1403,Sekou Doumbouya,96,30,1639,204,526,55,215,149,311,79,114,61,206,267,66,47,19,81,175,542
1404,Semaj Christon,64,1,973,77,223,12,63,65,160,17,31,19,68,87,130,28,7,43,79,183
1405,Semi Ojeleye,314,24,4517,361,961,204,599,157,362,147,202,172,515,687,135,83,25,102,330,1073
1406,Semih Erden,110,25,1523,163,296,0,0,163,296,99,161,94,214,308,49,40,53,84,268,425
1407,Serge Ibaka,1052,788,28426,5194,10194,775,2125,4419,8069,1403,1838,2085,5216,7301,873,425,1916,1335,2797,12566
1408,Sergey Karasev,95,22,1110,96,243,31,110,65,133,64,76,30,110,140,87,32,4,57,94,287
1409,Sergio Rodríguez,200,46,3614,544,1238,156,434,388,804,154,213,69,266,335,768,149,14,356,263,1398
1410,Seth Curry,504,270,12848,2124,4454,983,2268,1141,2186,538,623,153,991,1144,1161,365,74,585,867,5769
1411,Shabazz Muhammad,321,18,5190,1024,2176,130,413,894,1763,540,717,317,529,846,165,90,27,189,313,2718
1412,Shabazz Napier,401,88,7330,996,2490,421,1240,575,1250,598,732,130,685,815,1111,355,59,580,505,3011
1413,Shaedon Sharpe,80,15,1779,306,648,102,283,204,365,75,105,63,173,236,94,38,24,83,136,789
1414,Shai Gilgeous-Alexander,311,302,10140,2287,4729,356,1025,1931,3704,1626,1925,219,1198,1417,1411,385,226,727,696,6556
1415,Shake Milton,254,45,5280,882,1937,242,663,640,1274,362,437,126,478,604,694,120,63,294,473,2368
1416,Shamorie Ponds,4,0,11,3,5,1,2,2,3,2,2,0,1,1,2,0,1,0,2,9
1417,Shane Battier,441,266,11671,1006,2394,576,1522,430,872,275,390,381,1136,1517,751,346,365,314,833,2863
1418,Shane Edwards,2,0,12,1,3,0,0,1,3,0,0,1,1,2,0,0,0,1,1,2
1419,Shane Larkin,256,41,4880,545,1290,117,348,428,942,192,247,83,407,490,737,243,24,301,375,1399
1420,Shannon Brown,345,52,6661,1072,2555,246,741,826,1814,402,492,161,542,703,402,257,77,320,467,2792
1421,Shaq Buchanan,2,0,10,1,4,0,2,1,2,0,0,1,1,2,2,1,0,2,1,2
1422,Shaquille Harrison,214,23,3107,389,913,55,201,334,712,196,270,80,411,491,326,195,69,131,302,1029
1423,Shaquille O'Neal*,90,89,1992,396,664,0,1,396,663,185,357,141,392,533,106,31,104,161,289,977
1424,Sharife Cooper,13,0,39,3,14,1,6,2,8,0,0,0,5,5,5,0,0,5,1,7
1425,Shaun Livingston,778,164,15258,1942,3893,7,57,1935,3836,859,1043,416,1325,1741,2110,507,279,865,1297,4750
1426,Shavlik Randolph,84,0,651,65,168,0,10,65,158,33,66,81,118,199,15,23,16,27,103,163
1427,Shawn Long,18,0,234,61,109,7,19,54,90,19,35,41,44,85,13,9,9,13,49,148
1428,Shawn Marion,418,332,12077,1932,3923,121,401,1811,3522,461,596,813,1904,2717,687,396,258,558,666,4446
1429,Shawne Williams,251,74,4762,521,1324,276,784,245,540,133,160,177,629,806,181,118,134,140,571,1451
1430,Shayne Whittington,27,0,149,24,53,1,8,23,45,19,25,15,26,41,9,6,3,10,25,68
1431,Shelden Williams,230,111,3695,365,762,0,1,365,761,267,352,374,668,1042,120,106,112,182,486,997
1432,Sheldon Mac,30,3,287,30,75,7,30,23,45,23,27,4,30,34,15,8,2,5,17,90
1433,Shelvin Mack,596,89,11112,1568,3696,405,1220,1163,2476,477,660,152,1014,1166,1859,396,31,755,763,4018
1434,Sherron Collins,20,0,66,7,25,2,10,5,15,1,1,0,5,5,8,2,0,4,2,17
1435,Sim Bhullar,3,0,3,1,2,0,0,1,2,0,0,0,1,1,1,0,1,0,0,2
1436,Simone Fontecchio,52,6,766,115,312,63,191,52,121,35,44,31,55,86,42,15,8,39,62,328
1437,Sindarius Thornwell,181,20,1938,153,385,42,126,111,259,94,142,44,180,224,132,89,37,89,198,442
1438,Skal Labissière,170,43,2771,455,921,36,98,419,823,190,259,233,472,705,163,58,105,162,343,1136
1439,Skylar Mays,67,11,678,110,230,34,91,76,139,42,47,17,62,79,97,27,3,29,35,296
1440,Solomon Alabi,26,0,181,16,51,0,0,16,51,7,10,22,39,61,5,4,11,8,16,39
1441,Solomon Hill,507,193,10740,953,2453,425,1264,528,1189,445,562,318,1246,1564,766,350,111,428,850,2776
1442,Solomon Jones,146,5,1898,181,437,0,4,181,433,132,183,169,223,392,82,46,84,116,320,494
1443,Sonny Weems,214,47,3779,548,1191,49,158,499,1033,132,188,95,356,451,303,93,29,233,307,1277
1444,Spencer Dinwiddie,612,393,17636,2856,6798,1027,3026,1829,3772,1960,2466,279,1707,1986,3309,438,165,1063,1423,8699
1445,Spencer Hawes,670,388,15618,2469,5405,468,1279,2001,4126,706,947,944,3021,3965,1399,265,643,977,1646,6112
1446,Stanley Johnson,515,111,10087,1199,3070,402,1329,797,1741,460,612,287,1334,1621,767,443,120,561,985,3260
1447,Stanley Umude,1,0,2,0,1,0,1,0,0,2,2,0,0,0,0,1,1,0,0,2
1448,Stanton Kidd,4,0,15,0,3,0,1,0,2,0,0,0,3,3,1,0,0,2,3,0
1449,Stephen Curry,882,876,30302,7434,15653,3390,7929,4044,7724,3454,3801,592,3587,4179,5740,1419,207,2777,2098,21712
1450,Stephen Graham,129,36,1763,200,440,21,71,179,369,73,103,41,217,258,63,34,11,74,200,494
1451,Stephen Jackson,387,263,12269,2082,5101,524,1669,1558,3432,1164,1475,277,1320,1597,1162,495,155,1016,853,5852
1452,Stephen Zimmerman,19,0,108,10,31,0,0,10,31,3,5,11,24,35,4,2,5,3,17,23
1453,Sterling Brown,268,29,4458,531,1267,248,683,283,584,121,152,154,737,891,268,140,47,177,379,1431
1454,Steve Blake,586,152,13822,1240,3161,717,1900,523,1261,257,335,142,1149,1291,2380,402,49,852,861,3454
1455,Steve Nash*,283,278,9058,1465,2920,325,791,1140,2129,694,756,130,755,885,2830,165,31,946,336,3949
1456,Steve Novak,401,2,4497,573,1310,461,1050,112,260,83,96,47,413,460,94,65,37,60,302,1690
1457,Steven Adams,706,641,18944,2713,4619,1,15,2712,4604,1091,2036,2599,3189,5788,1079,624,675,1029,1748,6518
1458,Steven Hunter,21,0,158,17,43,0,0,17,43,19,36,18,24,42,0,1,10,9,10,53
1459,Sundiata Gaines,137,12,1612,224,563,53,184,171,379,118,214,59,154,213,249,99,4,120,125,619
1460,Svi Mykhailiuk,392,76,6445,919,2277,508,1423,411,854,241,325,133,567,700,551,227,42,359,363,2587
1461,T.J. Ford,102,35,2153,296,697,16,90,280,607,150,197,61,187,248,366,88,21,176,194,758
1462,T.J. Leaf,146,2,1238,204,415,31,91,173,324,38,65,95,188,283,43,26,28,32,103,477
1463,T.J. McConnell,556,92,12215,1753,3446,139,405,1614,3041,304,388,305,1365,1670,2801,694,104,909,824,3949
1464,T.J. Warren,416,236,10927,2388,4731,291,826,2097,3905,703,900,501,1113,1614,477,371,192,381,921,5770
1465,Tacko Fall,37,1,228,37,55,0,0,37,55,8,25,24,66,90,6,2,30,12,32,82
1466,Tahjere McCall,1,0,8,2,3,0,1,2,2,0,1,0,1,1,0,0,0,0,2,4
1467,Taj Gibson,1023,520,24445,3781,7305,55,208,3726,7097,1485,2083,2228,3827,6055,987,559,1004,1120,2503,9102
1468,Talen Horton-Tucker,196,44,4209,719,1670,148,529,571,1141,328,426,105,474,579,592,171,80,319,393,1914
1469,Tari Eason,82,5,1767,296,660,59,172,237,488,109,145,195,301,496,88,96,47,101,189,760
1470,Tarik Black,283,96,4515,596,1071,2,15,594,1056,260,453,535,864,1399,152,102,140,211,674,1454
1471,Tariq Owens,3,0,15,1,5,0,2,1,3,2,2,2,1,3,0,1,0,0,1,4
1472,Taurean Prince,465,232,11033,1685,4016,762,2038,923,1978,649,790,226,1490,1716,807,369,197,695,953,4781
1473,Taylor Griffin,8,0,32,4,10,0,2,4,8,2,4,0,2,2,1,0,2,1,4,10
1474,Tayshaun Prince,623,504,17779,2465,5544,260,689,2205,4855,614,850,533,1854,2387,1299,320,209,532,651,5804
1475,Terance Mann,270,85,5814,821,1643,198,517,623,1126,316,403,247,751,998,550,137,61,222,499,2156
1476,Terence Davis,288,28,4734,856,1979,428,1168,428,811,211,256,121,657,778,388,195,65,288,492,2351
1477,Terrance Ferguson,204,124,4000,334,827,195,583,139,244,61,81,75,188,263,144,92,43,93,476,924
1478,Terrel Harris,62,1,592,37,137,8,55,29,82,28,41,26,77,103,44,13,8,59,68,110
1479,Terrence Jones,288,130,6832,1216,2460,112,388,1104,2072,471,763,460,1180,1640,297,186,324,267,459,3015
1480,Terrence Ross,874,220,21241,3466,8243,1566,4322,1900,3921,929,1112,296,2125,2421,1119,709,274,811,1470,9427
1481,Terrence Williams,204,9,3762,565,1374,80,251,485,1123,194,299,84,614,698,467,112,26,298,259,1404
1482,Terry Rozier,540,298,14659,2673,6413,1116,3037,1557,3376,906,1106,363,1762,2125,1828,515,129,713,799,7368
1483,Terry Taylor,95,11,1242,213,370,22,76,191,294,48,73,149,117,266,61,20,20,41,113,496
1484,Thabo Sefolosha,663,413,15305,1475,3231,445,1252,1030,1979,490,665,487,2115,2602,896,766,280,538,1086,3885
1485,Thaddeus Young,1118,696,31718,5931,11884,514,1566,5417,10318,1350,2085,2198,4243,6441,2211,1594,465,1613,2398,13726
1486,Thanasis Antetokounmpo,164,11,1365,184,363,9,62,175,301,72,134,121,173,294,98,48,27,93,184,449
1487,Theo Pinson,127,1,1081,116,363,59,226,57,137,55,61,26,153,179,141,34,7,69,100,346
1488,Theo Ratliff,108,58,1685,141,310,0,0,141,310,76,102,124,203,327,53,26,127,85,181,358
1489,Thomas Bryant,288,160,5587,1156,1918,144,381,1012,1537,435,578,430,1219,1649,281,93,207,221,513,2891
1490,Thomas Robinson,437,16,6058,904,1942,0,9,904,1933,361,706,759,1366,2125,269,234,157,466,774,2169
1491,Thomas Welsh,11,0,36,7,13,3,7,4,6,1,2,0,4,4,5,0,0,1,3,18
1492,Thon Maker,327,70,4596,534,1244,179,550,355,694,292,431,259,669,928,206,117,224,175,565,1539
1493,Théo Maledon,160,63,3540,447,1185,177,558,270,627,243,309,59,406,465,490,124,34,265,254,1314
1494,Tiago Splitter,355,153,6812,1073,1932,2,14,1071,1918,668,958,576,1203,1779,423,198,209,384,685,2816
1495,Tibor Pleiß,12,0,82,11,25,0,2,11,23,2,2,6,9,15,2,1,2,8,19,24
1496,Tim Duncan*,493,491,14227,2909,5795,6,40,2903,5755,1426,1938,1067,3477,4544,1378,336,902,886,910,7250
1497,Tim Frazier,422,111,7396,762,1882,195,588,567,1294,360,505,217,762,979,1646,267,34,560,755,2079
1498,Tim Hardaway Jr.,722,396,20046,3582,8595,1627,4531,1955,4064,1551,1909,250,1873,2123,1383,469,103,787,1249,10342
1499,Tim Ohlbrecht,3,0,12,1,3,0,0,1,3,1,1,0,1,1,1,1,0,4,1,3
1500,Tim Quarterman,19,0,93,14,32,5,15,9,17,2,5,4,13,17,12,2,3,13,7,35
1501,Tim Thomas,18,1,285,49,106,16,43,33,63,21,24,13,28,41,14,10,2,14,31,135
1502,Timofey Mozgov,580,367,10750,1607,3000,13,64,1594,2936,793,1082,1018,1919,2937,320,187,505,678,1309,4020
1503,Timothé Luwawu-Cabarrot,378,67,5923,730,1875,356,1072,374,803,352,428,135,618,753,319,151,50,253,678,2168
1504,Tobias Harris,1120,977,35381,6952,14613,1580,4236,5372,10377,2763,3326,1121,5842,6963,2573,844,592,1596,2294,18247
1505,Tomáš Satoranský,443,195,9523,1069,2323,248,723,821,1600,488,597,339,904,1243,1770,338,65,559,729,2874
1506,Toney Douglas,516,82,9475,1354,3361,557,1574,797,1787,480,578,265,835,1100,1108,439,38,525,1001,3745
1507,Tony Allen,538,367,12750,1836,3854,70,262,1766,3592,819,1199,813,1343,2156,710,866,239,713,1312,4561
1508,Tony Battie,80,11,806,78,187,3,8,75,179,19,28,29,160,189,31,13,23,19,104,178
1509,Tony Bradley,221,26,2678,477,745,6,15,471,730,132,193,362,606,968,127,57,129,134,308,1092
1510,Tony Mitchell,24,0,89,8,17,1,2,7,15,11,19,16,11,27,3,7,3,4,9,28
1511,Tony Parker,642,546,17944,3716,7546,209,611,3507,6935,1613,2062,156,1337,1493,3581,447,54,1332,903,9254
1512,Tony Snell,654,322,13915,1404,3268,773,1976,631,1292,278,328,188,1286,1474,697,282,147,348,916,3859
1513,Tony Wroten,145,34,3076,575,1393,84,363,491,1030,370,572,106,257,363,437,137,28,375,268,1604
1514,Tornike Shengelia,71,0,401,36,79,1,14,35,65,15,32,17,38,55,31,9,3,35,47,88
1515,Torrey Craig,507,177,9950,1192,2604,455,1317,737,1287,237,334,623,1396,2019,541,270,283,346,1020,3076
1516,Toure' Murry,61,0,409,60,139,5,12,55,127,27,43,15,31,46,51,21,1,42,50,152
1517,Tracy McGrady*,184,87,3869,510,1215,77,249,433,966,240,338,116,477,593,560,112,77,243,216,1337
1518,Trae Young,353,353,11941,2866,6551,884,2517,1982,4034,2374,2711,240,1062,1302,3285,342,51,1461,587,8990
1519,Travis Diener,18,0,102,4,20,2,14,2,6,2,8,0,6,6,16,8,0,0,4,12
1520,Travis Leslie,10,0,45,5,14,0,0,5,14,4,9,6,3,9,5,2,2,2,4,14
1521,Travis Outlaw,290,78,5827,758,1971,227,689,531,1282,341,439,192,665,857,237,120,118,200,397,2084
1522,Travis Wear,68,1,900,109,281,28,77,81,204,28,34,31,113,144,47,19,16,41,85,274
1523,Trayvon Palmer,1,0,17,0,1,0,0,0,1,0,0,0,2,2,0,0,0,1,2,0
1524,Tre Jones,174,77,3401,544,1160,58,214,486,946,236,282,93,328,421,720,139,16,169,189,1382
1525,Tre Mann,127,31,2550,428,1089,179,529,249,560,107,137,52,274,326,211,87,23,133,201,1142
1526,Tre Scott,2,0,11,3,6,0,1,3,5,0,0,1,1,2,0,1,1,0,2,6
1527,Tremont Waters,43,4,457,56,161,23,80,33,81,24,25,5,36,41,92,35,3,50,38,159
1528,Trendon Watford,110,22,2051,323,590,34,102,289,488,143,194,99,338,437,211,57,40,115,234,823
1529,Trent Forrest,113,9,1344,133,286,10,55,123,231,59,70,39,141,180,189,46,12,84,82,335
1530,Trenton Hassell,52,31,1106,90,219,0,5,90,214,52,69,56,96,152,50,17,9,47,91,232
1531,Trevelin Queen,17,0,144,22,62,11,39,11,23,9,9,15,18,33,10,7,6,14,10,64
1532,Treveon Graham,235,64,3812,353,936,153,480,200,456,141,208,172,378,550,189,100,22,105,399,1000
1533,Trevon Duval,3,0,6,2,3,1,1,1,2,0,0,0,1,1,2,0,0,0,0,5
1534,Trevor Ariza,929,807,30591,3763,9146,1757,4986,2006,4160,1437,1872,759,4045,4804,2322,1434,308,1306,1851,10720
1535,Trevor Booker,600,169,12030,1725,3346,83,279,1642,3067,574,892,1146,2104,3250,648,383,298,599,1182,4107
1536,Trevor Hudgins,5,0,28,2,9,2,8,0,1,3,3,0,0,0,3,0,0,1,1,9
1537,Trevor Keels,3,0,8,1,4,1,4,0,0,0,0,0,2,2,0,0,0,0,0,3
1538,Trey Burke,589,139,12046,2177,5257,652,1871,1525,3386,660,812,208,819,1027,1764,323,61,625,732,5666
1539,Trey Gilder,2,0,5,1,1,0,0,1,1,0,0,0,1,1,0,1,0,0,0,2
1540,Trey Johnson,27,0,249,32,80,2,6,30,74,23,25,7,19,26,26,3,2,15,34,89
1541,Trey Lyles,598,149,11000,1734,3885,548,1616,1186,2269,835,1098,532,2100,2632,631,231,219,513,869,4851
1542,Trey McKinney-Jones,1,0,1,0,0,0,0,0,0,0,0,0,0,0,0,0,0,0,0,0
1543,Trey Murphy III,141,66,3312,496,1077,273,683,223,394,217,241,106,322,428,150,112,50,77,215,1482
1544,Trey Thompkins,24,0,119,24,61,4,13,20,48,5,7,4,20,24,3,3,3,6,10,57
1545,Tristan Thompson,787,484,20452,2795,5384,11,41,2784,5343,1335,2223,2524,3884,6408,759,387,522,870,1753,6936
1546,Troy Brown Jr.,331,84,6475,802,1867,281,802,521,1065,225,293,252,997,1249,477,221,45,226,468,2110
1547,Troy Caupain,4,0,16,4,8,2,3,2,5,0,0,1,2,3,4,1,0,0,0,10
1548,Troy Daniels,433,20,5974,900,2265,644,1654,256,611,164,208,94,437,531,224,117,25,219,506,2608
1549,Troy Murphy,215,78,4488,567,1273,177,501,390,772,210,273,220,983,1203,254,127,62,173,396,1521
1550,Troy Williams,123,34,2040,292,650,72,244,220,406,91,139,86,237,323,93,104,36,111,225,747
1551,Ty Jerome,157,7,2733,408,970,174,494,234,476,114,138,43,250,293,408,88,19,132,227,1104
1552,Ty Lawson,617,357,17499,2635,5778,509,1427,2126,4351,1571,2050,377,1249,1626,3553,689,59,1254,985,7350
1553,Ty-Shon Alexander,15,0,47,3,12,2,9,1,3,1,2,2,8,10,6,0,1,3,2,9
1554,TyTy Washington Jr.,31,2,433,58,160,19,80,39,80,10,18,2,43,45,47,15,2,14,29,145
1555,Tyler Bey,18,0,71,7,22,1,4,6,18,3,5,8,11,19,3,0,1,3,6,18
1556,Tyler Cavanaugh,50,1,557,70,162,33,94,37,68,19,23,48,87,135,28,9,4,15,64,192
1557,Tyler Cook,110,4,1184,177,268,2,4,175,264,69,118,84,187,271,39,26,8,55,108,425
1558,Tyler Davis,1,0,1,0,1,0,0,0,1,0,0,1,0,1,0,0,0,0,0,0
1559,Tyler Dorsey,155,27,2378,362,915,161,465,201,450,121,185,72,286,358,191,45,9,91,169,1006
1560,Tyler Ennis,272,24,3335,462,1115,105,321,357,794,99,127,64,266,330,518,141,25,258,327,1128
1561,Tyler Hall,1,0,2,0,0,0,0,0,0,0,0,0,0,0,0,0,0,0,0,0
1562,Tyler Hansbrough,428,50,7233,947,2156,3,22,944,2134,984,1333,745,1063,1808,181,207,91,319,869,2881
1563,Tyler Herro,242,100,7631,1565,3561,601,1571,964,1990,541,618,100,1081,1181,848,164,50,520,343,4272
1564,Tyler Honeycutt,24,0,120,11,35,1,5,10,30,5,7,6,18,24,9,4,4,7,5,28
1565,Tyler Johnson,456,107,11038,1566,3720,571,1609,995,2111,676,869,242,1088,1330,1060,361,179,481,799,4379
1566,Tyler Lydon,26,0,96,9,18,4,10,5,8,1,3,7,11,18,6,2,0,4,10,23
1567,Tyler Ulis,133,58,2782,398,988,63,225,335,763,139,172,44,179,223,537,118,12,204,193,998
1568,Tyler Zeller,486,201,8456,1364,2648,20,64,1344,2584,612,805,758,1391,2149,418,120,279,399,1043,3360
1569,Tyreke Evans,634,432,19030,3660,8348,542,1666,3118,6682,1896,2507,513,2344,2857,2976,769,231,1550,1368,9758
1570,Tyrell Terry,13,0,59,6,17,0,7,6,10,1,3,0,6,6,6,5,0,2,3,13
1571,Tyrese Haliburton,268,230,9018,1564,3278,604,1476,960,1802,543,637,194,806,1000,2150,436,151,631,394,4275
1572,Tyrese Martin,16,0,66,9,23,1,7,8,16,2,2,5,7,12,2,1,0,2,2,21
1573,Tyrese Maxey,196,123,5601,1120,2337,323,781,797,1556,454,529,60,460,520,653,130,53,209,367,3017
1574,Tyrone Wallace,112,19,1714,223,528,17,82,206,446,103,157,44,192,236,127,58,22,94,192,566
1575,Tyrus Thomas,231,40,4681,713,1635,4,20,709,1615,438,602,292,862,1154,196,206,311,319,566,1868
1576,Tyshawn Taylor,61,3,491,63,178,9,25,54,153,39,57,5,28,33,57,25,1,56,54,174
1577,Tyson Chandler,678,528,17431,1948,3059,0,6,1948,3053,1373,2012,1925,4008,5933,536,362,602,853,1695,5269
1578,Tyus Jones,535,94,10317,1401,3215,420,1176,981,2039,408,501,131,868,999,2108,527,39,400,410,3630
1579,Udoka Azubuike,68,10,611,100,130,0,0,100,130,21,41,53,150,203,11,8,30,33,68,221
1580,Udonis Haslem,440,115,7910,895,1916,9,58,886,1858,383,517,556,1687,2243,229,147,101,284,811,2182
1581,Usman Garuba,99,3,1210,105,221,29,79,76,142,34,54,141,249,390,81,54,40,53,163,273
1582,Vander Blue,10,1,134,12,39,2,13,10,26,4,12,2,11,13,12,4,0,11,7,30
1583,Vernon Carey Jr.,44,6,231,34,70,1,7,33,63,23,39,25,37,62,5,7,9,13,26,92
1584,Vernon Macklin,23,0,135,19,35,0,0,19,35,8,14,14,20,34,5,4,4,3,9,46
1585,Viacheslav Kravtsov,45,0,283,41,61,0,0,41,61,15,45,33,29,62,10,5,10,20,39,97
1586,Vic Law,8,0,62,6,18,1,7,5,11,2,6,2,9,11,3,2,0,2,6,15
1587,Victor Claver,80,16,1072,100,251,34,116,66,135,24,41,43,135,178,56,30,16,58,103,258
1588,Victor Oladipo,537,430,17327,3353,7728,892,2588,2461,5140,1557,1981,301,2104,2405,2121,851,244,1349,1283,9155
1589,Vince Carter,837,276,19147,3015,7299,1214,3321,1801,3978,1252,1574,459,2179,2638,1545,628,306,829,1837,8496
1590,Vince Edwards,2,0,16,1,4,1,4,0,0,0,0,1,1,2,0,0,0,0,0,3
1591,Vince Hunter,4,0,7,3,5,0,0,3,5,0,0,2,1,3,0,0,1,1,0,6
1592,Vince Williams Jr.,15,1,105,12,40,4,28,8,12,2,2,4,11,15,4,6,2,5,12,30
1593,Vincent Poirier,32,0,169,20,48,1,3,19,45,8,13,19,38,57,10,2,12,12,33,49
1594,Vit Krejci,59,8,855,83,204,37,119,46,85,20,24,24,103,127,74,24,9,34,82,223
1595,Vladimir Radmanović,230,49,3850,430,1104,185,551,245,553,94,120,210,529,739,231,131,77,187,442,1139
1596,Vlatko Čančar,130,11,1391,170,355,60,166,110,189,61,72,48,171,219,114,36,20,63,127,461
1597,Von Wafer,91,3,1022,138,316,32,106,106,210,70,92,13,81,94,64,28,8,55,65,378
1598,Vítor Luiz Faverani,37,8,488,64,147,12,40,52,107,24,37,42,86,128,16,14,27,41,74,164
1599,Wade Baldwin,56,1,579,60,169,9,36,51,133,45,58,14,55,69,78,21,10,57,63,174
1600,Walker Kessler,74,40,1703,298,414,1,3,297,411,82,159,231,389,620,69,26,173,58,169,679
1601,Walker Russell,28,0,357,33,95,4,13,29,82,14,22,7,19,26,58,18,1,33,29,84
1602,Walt Lemon Jr.,11,3,202,45,103,3,6,42,97,10,14,4,25,29,35,11,2,14,19,103
1603,Wayne Ellington,901,265,19058,2643,6427,1446,3787,1197,2640,617,729,277,1639,1916,1028,511,75,605,1057,7349
1604,Wayne Selden,216,45,4061,559,1355,174,528,385,827,208,291,92,357,449,311,96,33,236,358,1500
1605,Wendell Carter Jr.,314,290,8658,1504,2925,192,602,1312,2323,750,1024,749,1994,2743,640,195,254,516,934,3950
1606,Wendell Moore Jr.,29,2,153,18,43,2,17,16,26,4,5,4,14,18,18,8,5,8,13,42
1607,Wenyen Gabriel,201,14,2452,329,636,51,164,278,472,143,229,256,382,638,91,67,79,125,390,852
1608,Wes Iwundu,267,55,4366,379,947,79,294,300,653,251,313,130,515,645,226,117,55,139,390,1088
1609,Wesley Johnson,647,347,14006,1674,4156,639,1899,1035,2257,376,509,349,1647,1996,668,482,414,543,1231,4363
1610,Wesley Matthews,1019,821,30257,4067,9724,1971,5248,2096,4476,1835,2229,521,2353,2874,1980,963,210,1154,2116,11940
1611,Will Barton,793,288,19092,3112,7278,982,2781,2130,4497,1195,1518,512,2579,3091,2010,580,304,1057,1176,8401
1612,Will Bynum,288,28,5646,940,2135,79,281,861,1854,498,620,103,371,474,1009,215,27,488,575,2457
1613,Will Cherry,8,0,69,5,19,2,9,3,10,3,6,1,4,5,8,6,1,4,10,15
1614,Will Conroy,9,0,56,3,19,0,6,3,13,1,4,1,3,4,7,0,0,4,6,7
1615,Will Magnay,1,0,3,0,1,0,1,0,0,0,0,0,0,0,0,0,0,1,1,0
1616,William Howard,2,0,13,0,4,0,4,0,0,0,0,0,2,2,1,0,0,1,1,0
1617,Willie Cauley-Stein,496,297,10556,1743,3190,7,35,1736,3155,606,991,791,2034,2825,678,405,399,431,1114,4099
1618,Willie Green,382,104,7157,1069,2440,305,812,764,1628,300,370,100,524,624,439,168,58,280,625,2743
1619,Willie Reed,194,17,2313,400,660,3,8,397,652,143,253,248,448,696,56,42,121,85,296,946
1620,Willie Warren,19,0,134,13,35,5,15,8,20,6,8,1,11,12,27,6,0,8,16,37
1621,Willy Hernangómez,392,49,5644,1065,1991,42,133,1023,1858,598,846,770,1395,2165,397,163,150,382,637,2770
1622,Wilson Chandler,682,479,20445,3252,7312,933,2694,2319,4618,992,1280,760,2865,3625,1204,457,438,915,1796,8429
1623,Xavier Cooks,10,1,126,17,28,0,1,17,27,4,10,16,22,38,6,6,4,8,13,38
1624,Xavier Henry,185,23,2905,368,907,41,126,327,781,273,430,81,270,351,120,100,23,139,264,1050
1625,Xavier Moon,14,0,157,28,60,6,17,22,43,3,5,2,15,17,29,7,3,7,11,65
1626,Xavier Munford,20,0,265,33,83,9,25,24,58,8,16,4,28,32,26,14,3,17,29,83
1627,Xavier Rathan-Mayes,5,0,118,12,42,1,14,11,28,4,9,0,5,5,18,6,3,11,18,29
1628,Xavier Silas,4,0,46,4,18,1,8,3,10,2,3,3,3,6,3,1,0,3,6,11
1629,Xavier Sneed,22,0,126,9,30,5,22,4,8,4,4,4,13,17,7,0,1,3,11,27
1630,Xavier Tillman Sr.,173,43,2966,453,821,36,129,417,692,129,213,261,463,724,233,151,77,123,276,1071
1631,Yakhouba Diawara,6,2,44,2,10,1,6,1,4,0,0,1,3,4,3,1,0,3,8,5
1632,Yante Maten,2,0,13,1,4,0,1,1,3,0,0,1,2,3,0,1,0,0,0,2
1633,Yao Ming*,5,5,91,18,37,0,0,18,37,15,16,7,20,27,4,0,8,7,13,51
1634,Yi Jianlian,145,62,2970,403,992,21,64,382,928,230,305,206,463,669,77,71,92,142,308,1057
1635,Yogi Ferrell,315,82,6545,903,2172,366,995,537,1177,340,408,95,572,667,795,216,41,292,457,2512
1636,Yuta Watanabe,179,9,2375,279,635,128,328,151,307,92,134,95,348,443,122,71,54,68,195,778
1637,Yves Pons,12,0,71,5,16,3,9,2,7,0,2,5,7,12,1,1,4,1,6,13
1638,Zabian Dowdell,24,0,292,51,125,3,10,48,115,16,17,5,15,20,51,20,2,29,30,121
1639,Zach Collins,245,42,4634,696,1460,151,441,545,1019,287,383,341,828,1169,380,97,174,323,609,1830
1640,Zach LaVine,555,468,17987,4057,8732,1235,3217,2822,5515,2030,2437,263,1958,2221,2187,492,163,1465,1198,11379
1641,Zach Lofton,1,0,4,0,1,0,1,0,0,0,0,0,0,0,0,1,0,1,0,0
1642,Zach Norvell,10,0,82,6,24,6,16,0,8,2,2,0,12,12,6,4,0,6,8,20
1643,Zach Randolph,610,503,19436,4092,8597,114,433,3978,8164,1820,2400,1992,4017,6009,1212,471,164,1174,1424,10118
1644,Zavier Simpson,4,4,174,19,52,1,8,18,44,5,5,2,19,21,30,5,4,10,15,44
1645,Zaza Pachulia,676,354,13284,1516,3170,0,21,1516,3149,1141,1492,1437,2529,3966,1032,478,218,838,1584,4173
1646,Zeke Nnaji,136,7,1823,256,486,78,204,178,282,93,142,135,215,350,45,41,40,61,213,683
1647,Zhaire Smith,13,2,143,17,45,6,19,11,26,8,12,3,12,15,12,5,2,8,12,48
1648,Zhou Qi,19,0,125,7,33,2,19,5,14,8,12,6,16,22,2,2,14,10,14,24
1649,Ziaire Williams,99,35,1907,275,620,101,339,174,281,60,77,42,166,208,100,49,18,78,171,711
1650,Zion Williamson,114,114,3650,1129,1866,23,67,1106,1799,660,955,289,504,793,409,105,64,325,242,2941
1651,Zoran Dragić,32,2,150,22,60,6,28,16,32,6,10,10,6,16,10,4,0,10,12,56
1652,Zydrunas Ilgauskas,136,57,2484,356,757,11,24,345,733,111,147,222,410,632,74,37,108,115,368,834
1653,Zylan Cheatham,5,0,56,6,12,0,3,6,9,0,0,3,6,9,3,1,1,4,10,12
1654,Álex Abrines,174,16,2777,305,789,219,595,86,194,95,108,49,199,248,88,92,22,72,291,924
1655,Ángel Delgado,2,0,15,1,5,0,0,1,5,1,2,2,2,4,0,1,0,0,2,3
1656,Ömer Aşık,489,262,9398,956,1817,0,1,956,1816,589,1075,1045,2364,3409,283,169,343,551,948,2501
